Account Number,Name,Income,Expenditure,Savings,Password
987654321,barjraj,66784,27360,39424,4321
987654321,barjraj,61317,57770,3547,4321
987654321,barjraj,70502,26890,43612,4321
987654321,barjraj,62461,23620,38841,4321
987654321,barjraj,72977,59550,13427,4321
987654321,barjraj,27712,13070,14642,4321
987654321,barjraj,42474,41890,584,4321
987654321,barjraj,45268,43950,1318,4321
987654321,barjraj,56103,52230,3873,4321
987654321,barjraj,42276,37100,5176,4321
987654321,barjraj,48865,28020,20845,4321
987654321,barjraj,37667,24380,13287,4321
987654321,barjraj,49778,47610,2168,4321
987654321,barjraj,55762,19360,36402,4321
987654321,barjraj,70546,68770,1776,4321
987654321,barjraj,67422,59570,7852,4321
987654321,barjraj,75694,34460,41234,4321
987654321,barjraj,29527,8110,21417,4321
987654321,barjraj,48304,30700,17604,4321
987654321,barjraj,44982,28200,16782,4321
987654321,barjraj,62516,57780,4736,4321
987654321,barjraj,47523,23660,23863,4321
987654321,barjraj,45532,40520,5012,4321
987654321,barjraj,49305,18650,30655,4321
987654322,ramdin verma,53298,34300,18998,4322
987654322,ramdin verma,68159,52600,15559,4322
987654322,ramdin verma,70821,40080,30741,4322
987654322,ramdin verma,108573,58620,49953,4322
987654322,ramdin verma,87651,34780,52871,4322
987654322,ramdin verma,26524,16000,10524,4322
987654322,ramdin verma,43563,31520,12043,4322
987654322,ramdin verma,44322,11850,32472,4322
987654322,ramdin verma,52935,26840,26095,4322
987654322,ramdin verma,45114,17460,27654,4322
987654322,ramdin verma,45433,30610,14823,4322
987654322,ramdin verma,33300,19580,13720,4322
987654322,ramdin verma,54266,31140,23126,4322
987654322,ramdin verma,56774,19140,37634,4322
987654322,ramdin verma,76244,53210,23034,4322
987654322,ramdin verma,68753,65690,3063,4322
987654322,ramdin verma,89246,33090,56156,4322
987654322,ramdin verma,28394,21250,7144,4322
987654322,ramdin verma,39009,17790,21219,4322
987654322,ramdin verma,46720,12230,34490,4322
987654322,ramdin verma,55465,45000,10465,4322
987654322,ramdin verma,45147,21080,24067,4322
987654322,ramdin verma,43178,11550,31628,4322
987654322,ramdin verma,29131,9760,19371,4322
987654323,sharat chandran,54398,50290,4108,4323
987654323,sharat chandran,63990,22580,41410,4323
987654323,sharat chandran,73582,63420,10162,4323
987654323,sharat chandran,78169,63310,14859,4323
987654323,sharat chandran,72999,38500,34499,4323
987654323,sharat chandran,37997,36840,1157,4323
987654323,sharat chandran,50031,33100,16931,4323
987654323,sharat chandran,44619,31850,12769,4323
987654323,sharat chandran,56103,48150,7953,4323
987654323,sharat chandran,51868,39320,12548,4323
987654323,sharat chandran,30132,10890,19242,4323
987654323,sharat chandran,50284,37950,12334,4323
987654323,sharat chandran,59821,15910,43911,4323
987654323,sharat chandran,73736,49540,24196,4323
987654323,sharat chandran,70348,24170,46178,4323
987654323,sharat chandran,88938,55630,33308,4323
987654323,sharat chandran,31221,8840,22381,4323
987654323,sharat chandran,58303,30210,28093,4323
987654323,sharat chandran,62362,60770,1592,4323
987654323,sharat chandran,47589,46550,1039,4323
987654323,sharat chandran,49811,21620,28191,4323
987654323,sharat chandran,30022,22230,7792,4323
987654323,sharat chandran,63154,49480,13674,4323
987654323,sharat chandran,59282,54870,4412,4323
987654324,birender mandal,72218,34370,37848,4324
987654324,birender mandal,69325,62650,6675,4324
987654324,birender mandal,75991,37010,38981,4324
987654324,birender mandal,39570,21690,17880,4324
987654324,birender mandal,75804,70460,5344,4324
987654324,birender mandal,74484,73930,554,4324
987654324,birender mandal,75551,57880,17671,4324
987654324,birender mandal,71833,69420,2413,4324
987654324,birender mandal,32156,30500,1656,4324
987654324,birender mandal,40538,19250,21288,4324
987654324,birender mandal,39548,24110,15438,4324
987654324,birender mandal,55432,17980,37452,4324
987654324,birender mandal,36281,12020,24261,4324
987654324,birender mandal,46104,37870,8234,4324
987654324,birender mandal,33806,29120,4686,4324
987654324,birender mandal,54508,38990,15518,4324
987654324,birender mandal,59161,32380,26781,4324
987654324,birender mandal,78532,35140,43392,4324
987654324,birender mandal,72339,69350,2989,4324
987654324,birender mandal,76497,52280,24217,4324
987654324,birender mandal,29362,22640,6722,4324
987654324,birender mandal,42144,18520,23624,4324
987654324,birender mandal,41803,20650,21153,4324
987654324,birender mandal,58424,51580,6844,4324
987654325,amit,50548,23790,26758,4325
987654325,amit,48986,43480,5506,4325
987654325,amit,67928,35010,32918,4325
987654325,amit,71283,54430,16853,4325
987654325,amit,111257,52890,58367,4325
987654325,amit,96143,94050,2093,4325
987654325,amit,33201,19140,14061,4325
987654325,amit,41880,16290,25590,4325
987654325,amit,43112,37690,5422,4325
987654325,amit,56730,55780,950,4325
987654325,amit,48876,27880,20996,4325
987654325,amit,46093,34270,11823,4325
987654325,amit,32222,18440,13782,4325
987654325,amit,52429,31110,21319,4325
987654325,amit,63187,28010,35177,4325
987654325,amit,77454,48500,28954,4325
987654325,amit,71107,60360,10747,4325
987654325,amit,79379,74840,4539,4325
987654325,amit,30913,28180,2733,4325
987654325,amit,37810,10950,26860,4325
987654325,amit,44795,14860,29935,4325
987654325,amit,54519,36950,17569,4325
987654325,amit,45125,34840,10285,4325
987654325,amit,43717,16500,27217,4325
987654326,kushal,35401,17600,17801,4326
987654326,kushal,53133,46160,6973,4326
987654326,kushal,60932,33630,27302,4326
987654326,kushal,71338,25770,45568,4326
987654326,kushal,72790,68520,4270,4326
987654326,kushal,78851,49220,29631,4326
987654326,kushal,33432,21560,11872,4326
987654326,kushal,44322,42060,2262,4326
987654326,kushal,44465,25160,19305,4326
987654326,kushal,51406,42180,9226,4326
987654326,kushal,41385,33560,7825,4326
987654326,kushal,40043,39580,463,4326
987654326,kushal,33135,20590,12545,4326
987654326,kushal,52077,40510,11567,4326
987654326,kushal,64342,38880,25462,4326
987654326,kushal,68038,66080,1958,4326
987654326,kushal,67323,41710,25613,4326
987654326,kushal,82338,75810,6528,4326
987654326,kushal,30979,13790,17189,4326
987654326,kushal,40197,19280,20917,4326
987654326,kushal,41495,16480,25015,4326
987654326,kushal,52583,19070,33513,4326
987654326,kushal,51263,36140,15123,4326
987654326,kushal,40538,19990,20548,4326
987654327,kasid,25765,6690,19075,4327
987654327,kasid,57940,29690,28250,4327
987654327,kasid,58105,54880,3225,4327
987654327,kasid,70535,46480,24055,4327
987654327,kasid,75287,65480,9807,4327
987654327,kasid,89785,28580,61205,4327
987654327,kasid,33817,23390,10427,4327
987654327,kasid,65189,43650,21539,4327
987654327,kasid,52605,43720,8885,4327
987654327,kasid,66432,21450,44982,4327
987654327,kasid,57918,30490,27428,4327
987654327,kasid,65321,64420,901,4327
987654327,kasid,28405,25730,2675,4327
987654327,kasid,35346,8900,26446,4327
987654327,kasid,41088,40170,918,4327
987654327,kasid,49844,32510,17334,4327
987654327,kasid,43585,33070,10515,4327
987654327,kasid,44982,12520,32462,4327
987654327,kasid,31793,23850,7943,4327
987654327,kasid,60096,15100,44996,4327
987654327,kasid,63990,37380,26610,4327
987654327,kasid,70106,35840,34266,4327
987654327,kasid,70964,45050,25914,4327
987654327,kasid,79687,42820,36867,4327
987654328,shiv prakash,33344,13950,19394,4328
987654328,shiv prakash,52462,48820,3642,4328
987654328,shiv prakash,57786,45240,12546,4328
987654328,shiv prakash,65475,48190,17285,4328
987654328,shiv prakash,73736,45610,28126,4328
987654328,shiv prakash,80468,57480,22988,4328
987654328,shiv prakash,34532,22960,11572,4328
987654328,shiv prakash,45587,18570,27017,4328
987654328,shiv prakash,25039,12370,12669,4328
987654328,shiv prakash,60723,28830,31893,4328
987654328,shiv prakash,66069,65560,509,4328
987654328,shiv prakash,43354,26010,17344,4328
987654328,shiv prakash,26887,21510,5377,4328
987654328,shiv prakash,83207,47080,36127,4328
987654328,shiv prakash,99377,36500,62877,4328
987654328,shiv prakash,50163,36690,13473,4328
987654328,shiv prakash,83394,65560,17834,4328
987654328,shiv prakash,89367,49960,39407,4328
987654328,shiv prakash,103095,81680,21415,4328
987654328,shiv prakash,104569,52910,51659,4328
987654328,shiv prakash,114689,69470,45219,4328
987654328,shiv prakash,37205,14740,22465,4328
987654328,shiv prakash,48557,34590,13967,4328
987654328,shiv prakash,50999,41880,9119,4328
987654329,vikram singh,64210,32370,31840,4329
987654329,vikram singh,57984,45650,12334,4329
987654329,vikram singh,53111,20780,32331,4329
987654329,vikram singh,32134,18470,13664,4329
987654329,vikram singh,70315,70240,75,4329
987654329,vikram singh,73351,54260,19091,4329
987654329,vikram singh,82943,56230,26713,4329
987654329,vikram singh,84384,26620,57764,4329
987654329,vikram singh,95494,35950,59544,4329
987654329,vikram singh,37744,35620,2124,4329
987654329,vikram singh,66762,64170,2592,4329
987654329,vikram singh,67389,36070,31319,4329
987654329,vikram singh,83548,57040,26508,4329
987654329,vikram singh,71701,58740,12961,4329
987654329,vikram singh,77498,30990,46508,4329
987654329,vikram singh,34015,15900,18115,4329
987654329,vikram singh,43838,27490,16348,4329
987654329,vikram singh,49877,27740,22137,4329
987654329,vikram singh,56081,42400,13681,4329
987654329,vikram singh,38228,17540,20688,4329
987654329,vikram singh,45807,34970,10837,4329
987654329,vikram singh,32849,20550,12299,4329
987654329,vikram singh,51285,39650,11635,4329
987654329,vikram singh,55179,29980,25199,4329
987654330,sanjay,75078,46150,28928,4330
987654330,sanjay,62241,27140,35101,4330
987654330,sanjay,70733,63810,6923,4330
987654330,sanjay,36501,30320,6181,4330
987654330,sanjay,59975,38610,21365,4330
987654330,sanjay,69457,63180,6277,4330
987654330,sanjay,78642,70000,8642,4330
987654330,sanjay,77245,74920,2325,4330
987654330,sanjay,83119,54290,28829,4330
987654330,sanjay,36435,34800,1635,4330
987654330,sanjay,59414,31500,27914,4330
987654330,sanjay,54926,46290,8636,4330
987654330,sanjay,42419,22260,20159,4330
987654330,sanjay,47336,19610,27726,4330
987654330,sanjay,28042,25970,2072,4330
987654330,sanjay,56136,35490,20646,4330
987654330,sanjay,63099,45490,17609,4330
987654330,sanjay,57951,32340,25611,4330
987654330,sanjay,59282,55650,3632,4330
987654330,sanjay,73021,24330,48691,4330
987654330,sanjay,28823,14670,14153,4330
987654330,sanjay,42452,37670,4782,4330
987654330,sanjay,47248,19510,27738,4330
987654330,sanjay,52132,41240,10892,4330
987654331,abhi,43882,29470,14412,4331
987654331,abhi,48227,43950,4277,4331
987654331,abhi,27547,12080,15467,4331
987654331,abhi,54057,18140,35917,4331
987654331,abhi,58193,33500,24693,4331
987654331,abhi,68852,65390,3462,4331
987654331,abhi,63968,40570,23398,4331
987654331,abhi,83262,76890,6372,4331
987654331,abhi,32849,26530,6319,4331
987654331,abhi,29659,10730,18929,4331
987654331,abhi,53375,32550,20825,4331
987654331,abhi,61295,58470,2825,4331
987654331,abhi,93151,76230,16921,4331
987654331,abhi,82734,66230,16504,4331
987654331,abhi,30055,24130,5925,4331
987654331,abhi,39493,29300,10193,4331
987654331,abhi,43101,22240,20861,4331
987654331,abhi,56004,33620,22384,4331
987654331,abhi,42694,18790,23904,4331
987654331,abhi,44124,11800,32324,4331
987654331,abhi,27283,23950,3333,4331
987654331,abhi,49481,15160,34321,4331
987654331,abhi,55014,27870,27144,4331
987654331,abhi,71239,61910,9329,4331
987654332,ram dutt gupta,68357,46170,22187,4332
987654332,ram dutt gupta,77047,45550,31497,4332
987654332,ram dutt gupta,28603,14240,14363,4332
987654332,ram dutt gupta,36633,11300,25333,4332
987654332,ram dutt gupta,45433,28250,17183,4332
987654332,ram dutt gupta,53595,48050,5545,4332
987654332,ram dutt gupta,54673,35510,19163,4332
987654332,ram dutt gupta,46159,40000,6159,4332
987654332,ram dutt gupta,28141,13280,14861,4332
987654332,ram dutt gupta,53133,29320,23813,4332
987654332,ram dutt gupta,59491,22170,37321,4332
987654332,ram dutt gupta,72845,39220,33625,4332
987654332,ram dutt gupta,70722,22000,48722,4332
987654332,ram dutt gupta,89983,32130,57853,4332
987654332,ram dutt gupta,32816,12970,19846,4332
987654332,ram dutt gupta,47578,42770,4808,4332
987654332,ram dutt gupta,40967,29910,11057,4332
987654332,ram dutt gupta,56477,42410,14067,4332
987654332,ram dutt gupta,40197,36070,4127,4332
987654332,ram dutt gupta,43277,20280,22997,4332
987654332,ram dutt gupta,30198,27460,2738,4332
987654332,ram dutt gupta,55784,15460,40324,4332
987654332,ram dutt gupta,61966,38470,23496,4332
987654332,ram dutt gupta,77696,22690,55006,4332
987654333,khadak singh,66080,28730,37350,4333
987654333,khadak singh,69985,62160,7825,4333
987654333,khadak singh,31397,17750,13647,4333
987654333,khadak singh,46478,25740,20738,4333
987654333,khadak singh,50746,22370,28376,4333
987654333,khadak singh,55190,14650,40540,4333
987654333,khadak singh,47589,42750,4839,4333
987654333,khadak singh,45818,26080,19738,4333
987654333,khadak singh,28592,23460,5132,4333
987654333,khadak singh,50647,43760,6887,4333
987654333,khadak singh,52979,52890,89,4333
987654333,khadak singh,69721,22060,47661,4333
987654333,khadak singh,64001,30250,33751,4333
987654333,khadak singh,69545,35940,33605,4333
987654333,khadak singh,36974,35880,1094,4333
987654333,khadak singh,59854,32620,27234,4333
987654333,khadak singh,69391,20840,48551,4333
987654333,khadak singh,69468,52530,16938,4333
987654333,khadak singh,58094,52570,5524,4333
987654333,khadak singh,71514,33160,38354,4333
987654333,khadak singh,24753,9250,15503,4333
987654333,khadak singh,43596,24620,18976,4333
987654333,khadak singh,42826,31220,11606,4333
987654333,khadak singh,56752,55020,1732,4333
987654334,gurmit singh,49679,20100,29579,4334
987654334,gurmit singh,41902,17580,24322,4334
987654334,gurmit singh,33179,20720,12459,4334
987654334,gurmit singh,54761,15060,39701,4334
987654334,gurmit singh,58545,23150,35395,4334
987654334,gurmit singh,78323,43520,34803,4334
987654334,gurmit singh,70051,61960,8091,4334
987654334,gurmit singh,77234,76040,1194,4334
987654334,gurmit singh,30946,11330,19616,4334
987654334,gurmit singh,37502,31780,5722,4334
987654334,gurmit singh,50207,38180,12027,4334
987654334,gurmit singh,50702,48630,2072,4334
987654334,gurmit singh,44179,26200,17979,4334
987654334,gurmit singh,43871,19800,24071,4334
987654334,gurmit singh,44553,34720,9833,4334
987654334,gurmit singh,57280,39730,17550,4334
987654334,gurmit singh,64144,55410,8734,4334
987654334,gurmit singh,72933,67060,5873,4334
987654334,gurmit singh,60074,53170,6904,4334
987654334,gurmit singh,117582,54740,62842,4334
987654334,gurmit singh,29164,15630,13534,4334
987654334,gurmit singh,51186,27520,23666,4334
987654334,gurmit singh,46445,33650,12795,4334
987654334,gurmit singh,52517,19350,33167,4334
987654335,chanderpal,41737,13590,28147,4335
987654335,chanderpal,44806,44700,106,4335
987654335,chanderpal,27734,25650,2084,4335
987654335,chanderpal,50372,21190,29182,4335
987654335,chanderpal,60041,32760,27281,4335
987654335,chanderpal,69380,62870,6510,4335
987654335,chanderpal,64210,37090,27120,4335
987654335,chanderpal,81414,69840,11574,4335
987654335,chanderpal,31947,8670,23277,4335
987654335,chanderpal,50328,29010,21318,4335
987654335,chanderpal,57137,48250,8887,4335
987654335,chanderpal,54816,15590,39226,4335
987654335,chanderpal,48513,39370,9143,4335
987654335,chanderpal,31903,31550,353,4335
987654335,chanderpal,55784,42720,13064,4335
987654335,chanderpal,65607,44130,21477,4335
987654335,chanderpal,77146,69360,7786,4335
987654335,chanderpal,61889,61450,439,4335
987654335,chanderpal,80600,28830,51770,4335
987654335,chanderpal,32563,24370,8193,4335
987654335,chanderpal,62714,18140,44574,4335
987654335,chanderpal,57313,48500,8813,4335
987654335,chanderpal,44542,42130,2412,4335
987654335,chanderpal,45983,44200,1783,4335
987654336,aman,27756,11140,16616,4336
987654336,aman,52902,46950,5952,4336
987654336,aman,53837,34010,19827,4336
987654336,aman,61504,16460,45044,4336
987654336,aman,56785,22240,34545,4336
987654336,aman,77036,59630,17406,4336
987654336,aman,27932,18040,9892,4336
987654336,aman,41649,16620,25029,4336
987654336,aman,45268,28290,16978,4336
987654336,aman,51780,30350,21430,4336
987654336,aman,43794,37490,6304,4336
987654336,aman,42540,17550,24990,4336
987654336,aman,26810,9260,17550,4336
987654336,aman,65849,60320,5529,4336
987654336,aman,56741,52410,4331,4336
987654336,aman,74143,60350,13793,4336
987654336,aman,65992,36930,29062,4336
987654336,aman,79742,56320,23422,4336
987654336,aman,32728,11620,21108,4336
987654336,aman,79016,21240,57776,4336
987654336,aman,84186,73670,10516,4336
987654336,aman,73417,70260,3157,4336
987654336,aman,71800,39150,32650,4336
987654336,aman,29791,13670,16121,4336
987654337,khursid,41825,11530,30295,4337
987654337,khursid,40505,35510,4995,4337
987654337,khursid,52407,32930,19477,4337
987654337,khursid,48689,41580,7109,4337
987654337,khursid,45686,33200,12486,4337
987654337,khursid,73197,39250,33947,4337
987654337,khursid,80567,27300,53267,4337
987654337,khursid,84791,54750,30041,4337
987654337,khursid,84934,68680,16254,4337
987654337,khursid,28394,23030,5364,4337
987654337,khursid,51791,38880,12911,4337
987654337,khursid,40681,27770,12911,4337
987654337,khursid,56642,39890,16752,4337
987654337,khursid,49305,37190,12115,4337
987654337,khursid,43431,32970,10461,4337
987654337,khursid,29285,27970,1315,4337
987654337,khursid,55256,19990,35266,4337
987654337,khursid,55938,31400,24538,4337
987654337,khursid,77223,46980,30243,4337
987654337,khursid,53562,21710,31852,4337
987654337,khursid,109068,60370,48698,4337
987654337,khursid,31045,9520,21525,4337
987654337,khursid,48579,47430,1149,4337
987654337,khursid,47930,24480,23450,4337
987654338,rajeev,55729,52990,2739,4338
987654338,rajeev,45026,40690,4336,4338
987654338,rajeev,42903,13570,29333,4338
987654338,rajeev,28339,15280,13059,4338
987654338,rajeev,55003,43790,11213,4338
987654338,rajeev,54530,40170,14360,4338
987654338,rajeev,69105,49610,19495,4338
987654338,rajeev,63935,34670,29265,4338
987654338,rajeev,77674,51010,26664,4338
987654338,rajeev,29538,7400,22138,4338
987654338,rajeev,36611,19830,16781,4338
987654338,rajeev,45972,28630,17342,4338
987654338,rajeev,50471,29380,21091,4338
987654338,rajeev,39405,11790,27615,4338
987654338,rajeev,41869,31420,10449,4338
987654338,rajeev,31573,27490,4083,4338
987654338,rajeev,58105,29200,28905,4338
987654338,rajeev,56983,39290,17693,4338
987654338,rajeev,74220,31320,42900,4338
987654338,rajeev,66146,53920,12226,4338
987654338,rajeev,80732,36310,44422,4338
987654338,rajeev,36930,34860,2070,4338
987654338,rajeev,48480,29800,18680,4338
987654338,rajeev,44058,43360,698,4338
987654339,durgesh,50108,27010,23098,4339
987654339,durgesh,38800,17630,21170,4339
987654339,durgesh,42914,13290,29624,4339
987654339,durgesh,28273,24390,3883,4339
987654339,durgesh,52770,23340,29430,4339
987654339,durgesh,54651,19530,35121,4339
987654339,durgesh,70689,39290,31399,4339
987654339,durgesh,65849,62640,3209,4339
987654339,durgesh,83504,38780,44724,4339
987654339,durgesh,27679,13090,14589,4339
987654339,durgesh,47644,35400,12244,4339
987654339,durgesh,45961,12290,33671,4339
987654339,durgesh,53408,17660,35748,4339
987654339,durgesh,44696,14280,30416,4339
987654339,durgesh,44146,11680,32466,4339
987654339,durgesh,27404,20950,6454,4339
987654339,durgesh,53408,26700,26708,4339
987654339,durgesh,66212,37850,28362,4339
987654339,durgesh,79258,35650,43608,4339
987654339,durgesh,77476,32380,45096,4339
987654339,durgesh,81172,78610,2562,4339
987654339,durgesh,32299,21650,10649,4339
987654339,durgesh,50768,49090,1678,4339
987654339,durgesh,46434,37960,8474,4339
987654340,nahar singh,47292,37210,10082,4340
987654340,nahar singh,40527,29510,11017,4340
987654340,nahar singh,40868,25070,15798,4340
987654340,nahar singh,25094,6660,18434,4340
987654340,nahar singh,51791,32490,19301,4340
987654340,nahar singh,55190,31650,23540,4340
987654340,nahar singh,60041,56640,3401,4340
987654340,nahar singh,72284,68870,3414,4340
987654340,nahar singh,77982,50170,27812,4340
987654340,nahar singh,27547,11590,15957,4340
987654340,nahar singh,42628,19410,23218,4340
987654340,nahar singh,44058,42600,1458,4340
987654340,nahar singh,54189,50240,3949,4340
987654340,nahar singh,46225,37490,8735,4340
987654340,nahar singh,47270,18660,28610,4340
987654340,nahar singh,31672,31110,562,4340
987654340,nahar singh,56686,48950,7736,4340
987654340,nahar singh,66971,21680,45291,4340
987654340,nahar singh,72647,45740,26907,4340
987654340,nahar singh,72317,42610,29707,4340
987654340,nahar singh,91567,72850,18717,4340
987654340,nahar singh,30440,23780,6660,4340
987654340,nahar singh,52902,17180,35722,4340
987654340,nahar singh,41429,38700,2729,4340
987654341,ram kumar,23708,6470,17238,4341
987654341,ram kumar,82888,71990,10898,4341
987654341,ram kumar,39251,32840,6411,4341
987654341,ram kumar,61482,32530,28952,4341
987654341,ram kumar,26557,24650,1907,4341
987654341,ram kumar,95120,30120,65000,4341
987654341,ram kumar,54431,47500,6931,4341
987654341,ram kumar,83394,65150,18244,4341
987654341,ram kumar,94229,43410,50819,4341
987654341,ram kumar,110289,79000,31289,4341
987654341,ram kumar,114194,109930,4264,4341
987654341,ram kumar,115349,93190,22159,4341
987654341,ram kumar,35676,23380,12296,4341
987654341,ram kumar,52968,50790,2178,4341
987654341,ram kumar,57632,32790,24842,4341
987654341,ram kumar,66652,41050,25602,4341
987654341,ram kumar,55014,20840,34174,4341
987654341,ram kumar,48392,44630,3762,4341
987654341,ram kumar,27954,25200,2754,4341
987654341,ram kumar,53056,49580,3476,4341
987654341,ram kumar,78873,43370,35503,4341
987654341,ram kumar,90302,57640,32662,4341
987654341,ram kumar,89587,39880,49707,4341
987654341,ram kumar,97276,33250,64026,4341
987654342,sunder paal,36853,33120,3733,4342
987654342,sunder paal,55377,39420,15957,4342
987654342,sunder paal,56719,29180,27539,4342
987654342,sunder paal,60558,43120,17438,4342
987654342,sunder paal,47413,30990,16423,4342
987654342,sunder paal,51439,41500,9939,4342
987654342,sunder paal,32695,22920,9775,4342
987654342,sunder paal,49294,12470,36824,4342
987654342,sunder paal,59447,46310,13137,4342
987654342,sunder paal,70370,64010,6360,4342
987654342,sunder paal,66256,39960,26296,4342
987654342,sunder paal,81865,53570,28295,4342
987654342,sunder paal,31199,13680,17519,4342
987654342,sunder paal,44542,17580,26962,4342
987654342,sunder paal,48348,29050,19298,4342
987654342,sunder paal,54860,29330,25530,4342
987654342,sunder paal,45356,44700,656,4342
987654342,sunder paal,44267,17630,26637,4342
987654342,sunder paal,34675,23840,10835,4342
987654342,sunder paal,59931,23930,36001,4342
987654342,sunder paal,61350,16140,45210,4342
987654342,sunder paal,76431,46590,29841,4342
987654342,sunder paal,70128,53210,16918,4342
987654342,sunder paal,87310,25440,61870,4342
987654343,maansingh aswal,29648,21710,7938,4343
987654343,maansingh aswal,60657,46390,14267,4343
987654343,maansingh aswal,69072,24010,45062,4343
987654343,maansingh aswal,44894,15640,29254,4343
987654343,maansingh aswal,42529,30670,11859,4343
987654343,maansingh aswal,27767,20300,7467,4343
987654343,maansingh aswal,49844,21800,28044,4343
987654343,maansingh aswal,55245,45220,10025,4343
987654343,maansingh aswal,64936,27070,37866,4343
987654343,maansingh aswal,60030,21530,38500,4343
987654343,maansingh aswal,71998,48590,23408,4343
987654343,maansingh aswal,26931,17160,9771,4343
987654343,maansingh aswal,45125,31530,13595,4343
987654343,maansingh aswal,43926,40380,3546,4343
987654343,maansingh aswal,55465,35520,19945,4343
987654343,maansingh aswal,39504,13480,26024,4343
987654343,maansingh aswal,49888,47440,2448,4343
987654343,maansingh aswal,32134,15050,17084,4343
987654343,maansingh aswal,54233,30230,24003,4343
987654343,maansingh aswal,54772,36700,18072,4343
987654343,maansingh aswal,77146,71870,5276,4343
987654343,maansingh aswal,69182,35010,34172,4343
987654343,maansingh aswal,81128,45100,36028,4343
987654343,maansingh aswal,29648,15230,14418,4343
987654344,rohit,51461,21650,29811,4344
987654344,rohit,29296,26580,2716,4344
987654344,rohit,57698,40990,16708,4344
987654344,rohit,42210,35960,6250,4344
987654344,rohit,61790,25000,36790,4344
987654344,rohit,37788,26000,11788,4344
987654344,rohit,53694,40710,12984,4344
987654344,rohit,63825,42220,21605,4344
987654344,rohit,73868,35230,38638,4344
987654344,rohit,70337,67310,3027,4344
987654344,rohit,74902,64180,10722,4344
987654344,rohit,29241,29200,41,4344
987654344,rohit,43519,32740,10779,4344
987654344,rohit,42320,20850,21470,4344
987654344,rohit,50394,45190,5204,4344
987654344,rohit,42133,13300,28833,4344
987654344,rohit,42287,18130,24157,4344
987654344,rohit,31331,19960,11371,4344
987654344,rohit,54574,38390,16184,4344
987654344,rohit,61218,51930,9288,4344
987654344,rohit,71987,21820,50167,4344
987654344,rohit,72438,33000,39438,4344
987654344,rohit,77135,29930,47205,4344
987654344,rohit,28020,23270,4750,4344
987654345,rohit,41803,11670,30133,4345
987654345,rohit,41704,30310,11394,4345
987654345,rohit,51879,20760,31119,4345
987654345,rohit,46269,14320,31949,4345
987654345,rohit,47435,27110,20325,4345
987654345,rohit,30913,12660,18253,4345
987654345,rohit,69160,20670,48490,4345
987654345,rohit,60877,38630,22247,4345
987654345,rohit,71294,29590,41704,4345
987654345,rohit,71899,27810,44089,4345
987654345,rohit,82063,40660,41403,4345
987654345,rohit,28086,21780,6306,4345
987654345,rohit,40252,11520,28732,4345
987654345,rohit,44058,43690,368,4345
987654345,rohit,48469,30780,17689,4345
987654345,rohit,42914,40280,2634,4345
987654345,rohit,41297,10760,30537,4345
987654345,rohit,30121,9070,21051,4345
987654345,rohit,53925,40810,13115,4345
987654345,rohit,57126,32010,25116,4345
987654345,rohit,79599,65950,13649,4345
987654345,rohit,67774,55650,12124,4345
987654345,rohit,71778,28920,42858,4345
987654345,rohit,28944,24800,4144,4345
987654346,sparsh,39141,27100,12041,4346
987654346,sparsh,43519,40760,2759,4346
987654346,sparsh,49217,19900,29317,4346
987654346,sparsh,37854,20680,17174,4346
987654346,sparsh,44806,17460,27346,4346
987654346,sparsh,29131,11310,17821,4346
987654346,sparsh,52616,51990,626,4346
987654346,sparsh,62120,43850,18270,4346
987654346,sparsh,91325,57460,33865,4346
987654346,sparsh,74902,57320,17582,4346
987654346,sparsh,79819,31970,47849,4346
987654346,sparsh,22729,11170,11559,4346
987654346,sparsh,37931,31510,6421,4346
987654346,sparsh,38921,13260,25661,4346
987654346,sparsh,47182,16270,30912,4346
987654346,sparsh,41066,11250,29816,4346
987654346,sparsh,40318,27330,12988,4346
987654346,sparsh,29450,12050,17400,4346
987654346,sparsh,53815,30930,22885,4346
987654346,sparsh,65057,23160,41897,4346
987654346,sparsh,68489,35410,33079,4346
987654346,sparsh,73450,29630,43820,4346
987654346,sparsh,93888,43710,50178,4346
987654346,sparsh,31298,24370,6928,4346
987654347,santosh,50735,30990,19745,4347
987654347,santosh,52572,15780,36792,4347
987654347,santosh,57764,35400,22364,4347
987654347,santosh,50680,38520,12160,4347
987654347,santosh,49140,12730,36410,4347
987654347,santosh,49624,34400,15224,4347
987654347,santosh,58248,50040,8208,4347
987654347,santosh,64100,21690,42410,4347
987654347,santosh,71877,60500,11377,4347
987654347,santosh,64562,60910,3652,4347
987654347,santosh,69776,31510,38266,4347
987654347,santosh,40637,37570,3067,4347
987654347,santosh,57951,15060,42891,4347
987654347,santosh,52781,27960,24821,4347
987654347,santosh,53639,44360,9279,4347
987654347,santosh,43211,27630,15581,4347
987654347,santosh,48348,30590,17758,4347
987654347,santosh,28306,18450,9856,4347
987654347,santosh,58743,55010,3733,4347
987654347,santosh,51593,37890,13703,4347
987654347,santosh,62868,20360,42508,4347
987654347,santosh,58479,28500,29979,4347
987654347,santosh,79929,50030,29899,4347
987654347,santosh,30044,17290,12754,4347
987654348,santosh,48887,41550,7337,4348
987654348,santosh,41473,17460,24013,4348
987654348,santosh,51098,35980,15118,4348
987654348,santosh,46643,11910,34733,4348
987654348,santosh,41726,15390,26336,4348
987654348,santosh,24786,23360,1426,4348
987654348,santosh,57687,50290,7397,4348
987654348,santosh,52616,13430,39186,4348
987654348,santosh,73582,50390,23192,4348
987654348,santosh,69160,49960,19200,4348
987654348,santosh,76629,31320,45309,4348
987654348,santosh,25765,17510,8255,4348
987654348,santosh,65156,32760,32396,4348
987654348,santosh,64122,51820,12302,4348
987654348,santosh,58875,40290,18585,4348
987654348,santosh,63132,59440,3692,4348
987654348,santosh,74341,29190,45151,4348
987654348,santosh,31133,8560,22573,4348
987654348,santosh,41638,24760,16878,4348
987654348,santosh,43156,32790,10366,4348
987654348,santosh,51373,31170,20203,4348
987654348,santosh,50108,17890,32218,4348
987654348,santosh,25853,9180,16673,4348
987654348,santosh,50482,35660,14822,4348
987654349,punit khandelwal,58567,16560,42007,4349
987654349,punit khandelwal,68973,50850,18123,4349
987654349,punit khandelwal,65123,45200,19923,4349
987654349,punit khandelwal,72724,29860,42864,4349
987654349,punit khandelwal,29802,23510,6292,4349
987654349,punit khandelwal,53848,42140,11708,4349
987654349,punit khandelwal,61735,34920,26815,4349
987654349,punit khandelwal,45521,40640,4881,4349
987654349,punit khandelwal,42320,18440,23880,4349
987654349,punit khandelwal,24940,11620,13320,4349
987654349,punit khandelwal,65398,62980,2418,4349
987654349,punit khandelwal,73769,70410,3359,4349
987654349,punit khandelwal,75672,49810,25862,4349
987654349,punit khandelwal,73857,21930,51927,4349
987654349,punit khandelwal,23554,9980,13574,4349
987654349,punit khandelwal,54134,29800,24334,4349
987654349,punit khandelwal,51659,48690,2969,4349
987654349,punit khandelwal,68940,28680,40260,4349
987654349,punit khandelwal,63605,17350,46255,4349
987654349,punit khandelwal,74594,62750,11844,4349
987654349,punit khandelwal,29791,13930,15861,4349
987654349,punit khandelwal,38855,32650,6205,4349
987654349,punit khandelwal,38756,33520,5236,4349
987654349,punit khandelwal,52616,27080,25536,4349
987654350,dinesh,44729,19600,25129,4350
987654350,dinesh,42430,22680,19750,4350
987654350,dinesh,28251,23370,4881,4350
987654350,dinesh,47754,43840,3914,4350
987654350,dinesh,58391,55920,2471,4350
987654350,dinesh,71800,60140,11660,4350
987654350,dinesh,72394,58300,14094,4350
987654350,dinesh,73736,50220,23516,4350
987654350,dinesh,27151,26780,371,4350
987654350,dinesh,42672,15160,27512,4350
987654350,dinesh,45334,40760,4574,4350
987654350,dinesh,46830,36410,10420,4350
987654350,dinesh,40153,31490,8663,4350
987654350,dinesh,48546,37790,10756,4350
987654350,dinesh,79599,33910,45689,4350
987654350,dinesh,86760,54980,31780,4350
987654350,dinesh,70304,28460,41844,4350
987654350,dinesh,92612,90160,2452,4350
987654350,dinesh,29681,26620,3061,4350
987654350,dinesh,54585,43320,11265,4350
987654350,dinesh,58622,18260,40362,4350
987654350,dinesh,74693,74440,253,4350
987654350,dinesh,68544,50650,17894,4350
987654350,dinesh,83603,77250,6353,4350
987654351,gulshan,32596,28910,3686,4351
987654351,gulshan,46071,36600,9471,4351
987654351,gulshan,43684,34810,8874,4351
987654351,gulshan,42694,38430,4264,4351
987654351,gulshan,32981,28560,4421,4351
987654351,gulshan,41638,40710,928,4351
987654351,gulshan,24368,17100,7268,4351
987654351,gulshan,53122,50300,2822,4351
987654351,gulshan,63297,51960,11337,4351
987654351,gulshan,75342,65120,10222,4351
987654351,gulshan,70007,29490,40517,4351
987654351,gulshan,88003,29220,58783,4351
987654351,gulshan,29153,25920,3233,4351
987654351,gulshan,47270,39900,7370,4351
987654351,gulshan,53529,33690,19839,4351
987654351,gulshan,52231,38570,13661,4351
987654351,gulshan,43189,22490,20699,4351
987654351,gulshan,34004,28980,5024,4351
987654351,gulshan,21189,14530,6659,4351
987654351,gulshan,50152,14060,36092,4351
987654351,gulshan,58116,20770,37346,4351
987654351,gulshan,67356,46380,20976,4351
987654351,gulshan,63154,60300,2854,4351
987654351,gulshan,82503,68120,14383,4351
987654352,arvind kumar yadav,26491,8170,18321,4352
987654352,arvind kumar yadav,42012,14820,27192,4352
987654352,arvind kumar yadav,48909,44100,4809,4352
987654352,arvind kumar yadav,55091,22240,32851,4352
987654352,arvind kumar yadav,43728,13120,30608,4352
987654352,arvind kumar yadav,47413,41900,5513,4352
987654352,arvind kumar yadav,33421,23380,10041,4352
987654352,arvind kumar yadav,46313,26840,19473,4352
987654352,arvind kumar yadav,61405,43390,18015,4352
987654352,arvind kumar yadav,70898,36670,34228,4352
987654352,arvind kumar yadav,69039,50390,18649,4352
987654352,arvind kumar yadav,71360,20250,51110,4352
987654352,arvind kumar yadav,32596,14100,18496,4352
987654352,arvind kumar yadav,50075,44390,5685,4352
987654352,arvind kumar yadav,47820,32400,15420,4352
987654352,arvind kumar yadav,48986,22040,26946,4352
987654352,arvind kumar yadav,38151,33000,5151,4352
987654352,arvind kumar yadav,39119,37430,1689,4352
987654352,arvind kumar yadav,24335,10800,13535,4352
987654352,arvind kumar yadav,50559,30340,20219,4352
987654352,arvind kumar yadav,56081,37030,19051,4352
987654352,arvind kumar yadav,65794,56600,9194,4352
987654352,arvind kumar yadav,63913,54920,8993,4352
987654352,arvind kumar yadav,69501,31920,37581,4352
987654353,nausad,26469,10260,16209,4353
987654353,nausad,37931,15790,22141,4353
987654353,nausad,32783,23220,9563,4353
987654353,nausad,46258,14890,31368,4353
987654353,nausad,44905,19560,25345,4353
987654353,nausad,44025,18470,25555,4353
987654353,nausad,29010,27660,1350,4353
987654353,nausad,52990,48200,4790,4353
987654353,nausad,61878,25230,36648,4353
987654353,nausad,74473,61710,12763,4353
987654353,nausad,69578,56230,13348,4353
987654353,nausad,74605,41330,33275,4353
987654353,nausad,25842,14250,11592,4353
987654353,nausad,49404,28170,21234,4353
987654353,nausad,45829,20390,25439,4353
987654353,nausad,48722,25580,23142,4353
987654353,nausad,154025,76230,77795,4353
987654353,nausad,114337,72920,41417,4353
987654353,nausad,115734,80940,34794,4353
987654353,nausad,113105,102240,10865,4353
987654353,nausad,130012,58940,71072,4353
987654353,nausad,102622,84520,18102,4353
987654353,nausad,91622,46980,44642,4353
987654353,nausad,80226,49120,31106,4353
987654354,gurmit singh,93613,71900,21713,4354
987654354,gurmit singh,101016,98260,2756,4354
987654354,gurmit singh,113193,47700,65493,4354
987654354,gurmit singh,106813,48780,58033,4354
987654354,gurmit singh,115734,111640,4094,4354
987654354,gurmit singh,125832,110670,15162,4354
987654354,gurmit singh,122466,109390,13076,4354
987654354,gurmit singh,135545,113970,21575,4354
987654354,gurmit singh,149130,39800,109330,4354
987654354,gurmit singh,121036,102300,18736,4354
987654354,gurmit singh,101027,70730,30297,4354
987654354,gurmit singh,100103,53540,46563,4354
987654354,gurmit singh,94900,50040,44860,4354
987654354,gurmit singh,89477,23050,66427,4354
987654354,gurmit singh,109717,88350,21367,4354
987654354,gurmit singh,103018,89410,13608,4354
987654354,gurmit singh,127053,111120,15933,4354
987654354,gurmit singh,113633,61370,52263,4354
987654354,gurmit singh,123456,44000,79456,4354
987654354,gurmit singh,144246,142860,1386,4354
987654354,gurmit singh,128692,96690,32002,4354
987654354,gurmit singh,98959,98220,739,4354
987654354,gurmit singh,84604,50730,33874,4354
987654354,gurmit singh,78301,53000,25301,4354
987654355,md. afsar,88608,42980,45628,4355
987654355,md. afsar,84065,46630,37435,4355
987654355,md. afsar,100378,27770,72608,4355
987654355,md. afsar,103194,27160,76034,4355
987654355,md. afsar,106626,34150,72476,4355
987654355,md. afsar,97760,46970,50790,4355
987654355,md. afsar,106615,43990,62625,4355
987654355,md. afsar,117461,79360,38101,4355
987654355,md. afsar,136458,46550,89908,4355
987654355,md. afsar,107649,69030,38619,4355
987654355,md. afsar,86859,66130,20729,4355
987654355,md. afsar,81557,32670,48887,4355
987654355,md. afsar,81975,74640,7335,4355
987654355,md. afsar,88102,72030,16072,4355
987654355,md. afsar,106120,49240,56880,4355
987654355,md. afsar,90478,22640,67838,4355
987654355,md. afsar,114656,93220,21436,4355
987654355,md. afsar,112280,107770,4510,4355
987654355,md. afsar,116911,82030,34881,4355
987654355,md. afsar,123522,113130,10392,4355
987654355,md. afsar,151077,93420,57657,4355
987654355,md. afsar,134137,77080,57057,4355
987654355,md. afsar,115899,102540,13359,4355
987654355,md. afsar,94130,83060,11070,4355
987654356,shiv shakti singh,91435,45990,45445,4356
987654356,shiv shakti singh,116537,94640,21897,4356
987654356,shiv shakti singh,111378,49740,61638,4356
987654356,shiv shakti singh,104360,47920,56440,4356
987654356,shiv shakti singh,98915,82860,16055,4356
987654356,shiv shakti singh,114403,89200,25203,4356
987654356,shiv shakti singh,109310,66180,43130,4356
987654356,shiv shakti singh,125711,90360,35351,4356
987654356,shiv shakti singh,120607,30930,89677,4356
987654356,shiv shakti singh,117835,74360,43475,4356
987654356,shiv shakti singh,110531,76750,33781,4356
987654356,shiv shakti singh,83053,80240,2813,4356
987654356,shiv shakti singh,88333,66170,22163,4356
987654356,shiv shakti singh,117087,56660,60427,4356
987654356,shiv shakti singh,111763,42680,69083,4356
987654356,shiv shakti singh,108342,80980,27362,4356
987654356,shiv shakti singh,113237,29010,84227,4356
987654356,shiv shakti singh,105493,57620,47873,4356
987654356,shiv shakti singh,131442,49840,81602,4356
987654356,shiv shakti singh,140330,67760,72570,4356
987654356,shiv shakti singh,177246,56970,120276,4356
987654356,shiv shakti singh,103700,76920,26780,4356
987654356,shiv shakti singh,118341,92250,26091,4356
987654356,shiv shakti singh,133928,42450,91478,4356
987654357,moti lal,94361,73010,21351,4357
987654357,moti lal,79005,53850,25155,4357
987654357,moti lal,77311,37790,39521,4357
987654357,moti lal,81964,43860,38104,4357
987654357,moti lal,74781,21110,53671,4357
987654357,moti lal,93987,79730,14257,4357
987654357,moti lal,123236,69770,53466,4357
987654357,moti lal,110355,78060,32295,4357
987654357,moti lal,108078,46870,61208,4357
987654357,moti lal,100510,31130,69380,4357
987654357,moti lal,110630,85550,25080,4357
987654357,moti lal,124413,55570,68843,4357
987654357,moti lal,104514,42900,61614,4357
987654357,moti lal,87464,63840,23624,4357
987654357,moti lal,94196,74100,20096,4357
987654357,moti lal,100994,55880,45114,4357
987654357,moti lal,124974,109370,15604,4357
987654357,moti lal,165278,78830,86448,4357
987654357,moti lal,190501,118590,71911,4357
987654357,moti lal,151121,109520,41601,4357
987654357,moti lal,159041,155320,3721,4357
987654357,moti lal,144367,69370,74997,4357
987654357,moti lal,116020,37790,78230,4357
987654357,moti lal,90390,63960,26430,4357
987654358,kausal kumar,81139,27320,53819,4358
987654358,kausal kumar,73571,23830,49741,4358
987654358,kausal kumar,82250,71630,10620,4358
987654358,kausal kumar,97133,76670,20463,4358
987654358,kausal kumar,110212,77070,33142,4358
987654358,kausal kumar,103711,70310,33401,4358
987654358,kausal kumar,100257,64720,35537,4358
987654358,kausal kumar,99894,96790,3104,4358
987654358,kausal kumar,107143,86510,20633,4358
987654358,kausal kumar,131827,84420,47407,4358
987654358,kausal kumar,111235,46120,65115,4358
987654358,kausal kumar,91061,85290,5771,4358
987654358,kausal kumar,77586,38210,39376,4358
987654358,kausal kumar,83812,73480,10332,4358
987654358,kausal kumar,84087,65780,18307,4358
987654358,kausal kumar,91204,25420,65784,4358
987654358,kausal kumar,112423,47730,64693,4358
987654358,kausal kumar,111510,50060,61450,4358
987654358,kausal kumar,114788,29040,85748,4358
987654358,kausal kumar,108771,36920,71851,4358
987654358,kausal kumar,122103,55600,66503,4358
987654358,kausal kumar,141969,104890,37079,4358
987654358,kausal kumar,126437,79070,47367,4358
987654358,kausal kumar,112753,53190,59563,4358
987654359,rohit,88960,42500,46460,4359
987654359,rohit,88641,66680,21961,4359
987654359,rohit,83801,66830,16971,4359
987654359,rohit,91688,59220,32468,4359
987654359,rohit,108397,45200,63197,4359
987654359,rohit,114711,79290,35421,4359
987654359,rohit,100334,54690,45644,4359
987654359,rohit,96814,77880,18934,4359
987654359,rohit,106307,105520,787,4359
987654359,rohit,122092,51910,70182,4359
987654359,rohit,113094,59640,53454,4359
987654359,rohit,94988,43390,51598,4359
987654359,rohit,90709,78720,11989,4359
987654359,rohit,80567,75170,5397,4359
987654359,rohit,87134,55470,31664,4359
987654359,rohit,98420,45240,53180,4359
987654359,rohit,110542,83490,27052,4359
987654359,rohit,120915,83460,37455,4359
987654359,rohit,108782,48800,59982,4359
987654359,rohit,105361,70530,34831,4359
987654359,rohit,123610,41790,81820,4359
987654359,rohit,144400,80150,64250,4359
987654359,rohit,131024,61720,69304,4359
987654359,rohit,146457,40360,106097,4359
987654360,rohit,105834,102610,3224,4360
987654360,rohit,93800,36520,57280,4360
987654360,rohit,100048,41370,58678,4360
987654360,rohit,111994,81360,30634,4360
987654360,rohit,103491,46320,57171,4360
987654360,rohit,84098,66210,17888,4360
987654360,rohit,79709,29590,50119,4360
987654360,rohit,82096,72330,9766,4360
987654360,rohit,80468,59390,21078,4360
987654360,rohit,97155,31510,65645,4360
987654360,rohit,106285,60060,46225,4360
987654360,rohit,99168,72090,27078,4360
987654360,rohit,105504,70870,34634,4360
987654360,rohit,102204,27500,74704,4360
987654360,rohit,97441,35870,61571,4360
987654360,rohit,122444,54300,68144,4360
987654360,rohit,117703,74410,43293,4360
987654360,rohit,95318,33030,62288,4360
987654360,rohit,90907,89260,1647,4360
987654360,rohit,99344,54620,44724,4360
987654360,rohit,115679,32810,82869,4360
987654360,rohit,123027,90680,32347,4360
987654360,rohit,107341,41950,65391,4360
987654360,rohit,118187,54480,63707,4360
987654361,mohabbat ali,111752,101450,10302,4361
987654361,mohabbat ali,185540,69120,116420,4361
987654361,mohabbat ali,149053,138270,10783,4361
987654361,mohabbat ali,140044,67940,72104,4361
987654361,mohabbat ali,72141,67080,5061,4361
987654361,mohabbat ali,174309,103660,70649,4361
987654361,mohabbat ali,160372,83790,76582,4361
987654361,mohabbat ali,152804,50270,102534,4361
987654361,mohabbat ali,149581,47120,102461,4361
987654361,mohabbat ali,145093,82110,62983,4361
987654361,mohabbat ali,144037,43740,100297,4361
987654361,mohabbat ali,140616,44380,96236,4361
987654361,mohabbat ali,166290,108250,58040,4361
987654361,mohabbat ali,131563,101820,29743,4361
987654361,mohabbat ali,92513,34370,58143,4361
987654361,mohabbat ali,93822,60520,33302,4361
987654361,mohabbat ali,88542,48070,40472,4361
987654361,mohabbat ali,92766,25880,66886,4361
987654361,mohabbat ali,105196,54500,50696,4361
987654361,mohabbat ali,127944,47350,80594,4361
987654361,mohabbat ali,130221,114690,15531,4361
987654361,mohabbat ali,117307,115100,2207,4361
987654361,mohabbat ali,128956,42250,86706,4361
987654361,mohabbat ali,122334,120760,1574,4361
987654362,raj kumar,136029,51640,84389,4362
987654362,raj kumar,154652,74510,80142,4362
987654362,raj kumar,152232,131750,20482,4362
987654362,raj kumar,115712,91720,23992,4362
987654362,raj kumar,110993,89290,21703,4362
987654362,raj kumar,125502,115310,10192,4362
987654362,raj kumar,132663,79310,53353,4362
987654362,raj kumar,116152,107040,9112,4362
987654362,raj kumar,91589,52550,39039,4362
987654362,raj kumar,86606,71130,15476,4362
987654362,raj kumar,86958,84010,2948,4362
987654362,raj kumar,91721,46890,44831,4362
987654362,raj kumar,103216,40200,63016,4362
987654362,raj kumar,123115,59440,63675,4362
987654362,raj kumar,107770,53690,54080,4362
987654362,raj kumar,111202,45190,66012,4362
987654362,raj kumar,102820,63710,39110,4362
987654362,raj kumar,96814,71910,24904,4362
987654362,raj kumar,116603,105500,11103,4362
987654362,raj kumar,112368,85310,27058,4362
987654362,raj kumar,123379,70120,53259,4362
987654362,raj kumar,104151,82830,21321,4362
987654362,raj kumar,123632,73390,50242,4362
987654362,raj kumar,124215,58940,65275,4362
987654363,jaswant singh,144125,116170,27955,4363
987654363,jaswant singh,119254,98330,20924,4363
987654363,jaswant singh,108309,92800,15509,4363
987654363,jaswant singh,106527,66290,40237,4363
987654363,jaswant singh,85990,75850,10140,4363
987654363,jaswant singh,83053,36690,46363,4363
987654363,jaswant singh,100972,29520,71452,4363
987654363,jaswant singh,103634,101650,1984,4363
987654363,jaswant singh,99256,25560,73696,4363
987654363,jaswant singh,103084,44330,58754,4363
987654363,jaswant singh,105097,58270,46827,4363
987654363,jaswant singh,107726,52670,55056,4363
987654363,jaswant singh,125007,51620,73387,4363
987654363,jaswant singh,111906,52070,59836,4363
987654363,jaswant singh,87497,27990,59507,4363
987654363,jaswant singh,88168,48680,39488,4363
987654363,jaswant singh,86353,32150,54203,4363
987654363,jaswant singh,89906,57620,32286,4363
987654363,jaswant singh,98497,32070,66427,4363
987654363,jaswant singh,110608,36920,73688,4363
987654363,jaswant singh,104591,45680,58911,4363
987654363,jaswant singh,96473,85890,10583,4363
987654363,jaswant singh,101159,65450,35709,4363
987654363,jaswant singh,106208,48560,57648,4363
987654364,sevak @ pitambar lal,116405,72730,43675,4364
987654364,sevak @ pitambar lal,128714,54400,74314,4364
987654364,sevak @ pitambar lal,135347,130300,5047,4364
987654364,sevak @ pitambar lal,116240,39670,76570,4364
987654364,sevak @ pitambar lal,139329,87130,52199,4364
987654364,sevak @ pitambar lal,112291,79890,32401,4364
987654364,sevak @ pitambar lal,103535,74710,28825,4364
987654364,sevak @ pitambar lal,76508,47780,28728,4364
987654364,sevak @ pitambar lal,72999,72730,269,4364
987654364,sevak @ pitambar lal,70920,29210,41710,4364
987654364,sevak @ pitambar lal,83053,63040,20013,4364
987654364,sevak @ pitambar lal,90104,80210,9894,4364
987654364,sevak @ pitambar lal,110564,75030,35534,4364
987654364,sevak @ pitambar lal,99025,34930,64095,4364
987654364,sevak @ pitambar lal,98618,83140,15478,4364
987654364,sevak @ pitambar lal,94614,52690,41924,4364
987654364,sevak @ pitambar lal,100620,64320,36300,4364
987654364,sevak @ pitambar lal,126030,123530,2500,4364
987654364,sevak @ pitambar lal,105273,62540,42733,4364
987654364,sevak @ pitambar lal,83713,48940,34773,4364
987654364,sevak @ pitambar lal,87244,41120,46124,4364
987654364,sevak @ pitambar lal,93910,56610,37300,4364
987654364,sevak @ pitambar lal,88850,87320,1530,4364
987654364,sevak @ pitambar lal,99025,25160,73865,4364
987654365,chotelal,103282,41090,62192,4365
987654365,chotelal,115888,31440,84448,4365
987654365,chotelal,115822,45210,70612,4365
987654365,chotelal,118099,35280,82819,4365
987654365,chotelal,131332,110520,20812,4365
987654365,chotelal,171625,92570,79055,4365
987654365,chotelal,131310,76910,54400,4365
987654365,chotelal,131398,45990,85408,4365
987654365,chotelal,101335,67180,34155,4365
987654365,chotelal,95978,39150,56828,4365
987654365,chotelal,98915,98710,205,4365
987654365,chotelal,120189,40980,79209,4365
987654365,chotelal,112368,111300,1068,4365
987654365,chotelal,113545,44850,68695,4365
987654365,chotelal,109574,87200,22374,4365
987654365,chotelal,104745,36700,68045,4365
987654365,chotelal,111873,58080,53793,4365
987654365,chotelal,149284,123470,25814,4365
987654365,chotelal,107396,74140,33256,4365
987654365,chotelal,99608,72270,27338,4365
987654365,chotelal,90610,76710,13900,4365
987654365,chotelal,86232,53270,32962,4365
987654365,chotelal,86936,62270,24666,4365
987654365,chotelal,106494,27290,79204,4365
987654366,amit,102006,44310,57696,4366
987654366,amit,106758,105080,1678,4366
987654366,amit,108672,56330,52342,4366
987654366,amit,97540,66880,30660,4366
987654366,amit,109970,33730,76240,4366
987654366,amit,129374,34900,94474,4366
987654366,amit,110861,91430,19431,4366
987654366,amit,122312,37320,84992,4366
987654366,amit,137943,59080,78863,4366
987654366,amit,110432,40800,69632,4366
987654366,amit,107968,34410,73558,4366
987654366,amit,121443,86020,35423,4366
987654366,amit,96935,86170,10765,4366
987654366,amit,84285,71440,12845,4366
987654366,amit,80985,69980,11005,4366
987654366,amit,71734,20190,51544,4366
987654366,amit,83559,67800,15759,4366
987654366,amit,95219,50730,44489,4366
987654366,amit,97320,35310,62010,4366
987654366,amit,102963,49470,53493,4366
987654366,amit,110575,51950,58625,4366
987654366,amit,118000,114790,3210,4366
987654366,amit,117989,56880,61109,4366
987654366,amit,142519,96950,45569,4366
987654367,rupesh,113765,90310,23455,4367
987654367,rupesh,101225,65320,35905,4367
987654367,rupesh,110080,68180,41900,4367
987654367,rupesh,99542,42260,57282,4367
987654367,rupesh,97364,27530,69834,4367
987654367,rupesh,107990,104830,3160,4367
987654367,rupesh,110454,76980,33474,4367
987654367,rupesh,94141,53660,40481,4367
987654367,rupesh,117329,99670,17659,4367
987654367,rupesh,116405,116060,345,4367
987654367,rupesh,127504,122240,5264,4367
987654367,rupesh,172472,81430,91042,4367
987654367,rupesh,105691,40820,64871,4367
987654367,rupesh,83196,82970,226,4367
987654367,rupesh,77960,67330,10630,4367
987654367,rupesh,93030,67860,25170,4367
987654367,rupesh,85033,50440,34593,4367
987654367,rupesh,99058,34760,64298,4367
987654367,rupesh,95593,56630,38963,4367
987654367,rupesh,104613,69870,34743,4367
987654367,rupesh,103986,102720,1266,4367
987654367,rupesh,96781,92220,4561,4367
987654367,rupesh,111147,54920,56227,4367
987654367,rupesh,122411,59200,63211,4367
987654368,midda,123379,89950,33429,4368
987654368,midda,88927,25700,63227,4368
987654368,midda,95087,69390,25697,4368
987654368,midda,89873,57460,32413,4368
987654368,midda,112709,88030,24679,4368
987654368,midda,111884,79110,32774,4368
987654368,midda,117835,39360,78475,4368
987654368,midda,118594,91250,27344,4368
987654368,midda,116504,72270,44234,4368
987654368,midda,121993,49890,72103,4368
987654368,midda,144037,112010,32027,4368
987654368,midda,121278,58160,63118,4368
987654368,midda,144719,129510,15209,4368
987654368,midda,121883,40760,81123,4368
987654368,midda,79203,46150,33053,4368
987654368,midda,87519,32570,54949,4368
987654368,midda,101478,40130,61348,4368
987654368,midda,94801,35140,59661,4368
987654368,midda,98244,78460,19784,4368
987654368,midda,92568,81730,10838,4368
987654368,midda,89477,22750,66727,4368
987654368,midda,125843,75310,50533,4368
987654368,midda,99520,70330,29190,4368
987654368,midda,87508,49980,37528,4368
987654369,dharam singh,78675,57570,21105,4369
987654369,dharam singh,80028,77430,2598,4369
987654369,dharam singh,82668,70550,12118,4369
987654369,dharam singh,93404,41600,51804,4369
987654369,dharam singh,116229,90490,25739,4369
987654369,dharam singh,119760,73360,46400,4369
987654369,dharam singh,101577,96500,5077,4369
987654369,dharam singh,101775,38050,63725,4369
987654369,dharam singh,107033,89790,17243,4369
987654369,dharam singh,131926,80650,51276,4369
987654369,dharam singh,113710,57860,55850,4369
987654369,dharam singh,168094,84380,83714,4369
987654369,dharam singh,162253,132790,29463,4369
987654369,dharam singh,106560,41360,65200,4369
987654369,dharam singh,130573,66260,64313,4369
987654369,dharam singh,95230,86740,8490,4369
987654369,dharam singh,77531,62150,15381,4369
987654369,dharam singh,80314,56900,23414,4369
987654369,dharam singh,80952,71320,9632,4369
987654369,dharam singh,107033,102230,4803,4369
987654369,dharam singh,116823,34220,82603,4369
987654369,dharam singh,144004,135230,8774,4369
987654369,dharam singh,123687,47860,75827,4369
987654369,dharam singh,123181,63720,59461,4369
987654370,manoj yadav,136381,35830,100551,4370
987654370,manoj yadav,101280,71290,29990,4370
987654370,manoj yadav,84582,58510,26072,4370
987654370,manoj yadav,84934,25240,59694,4370
987654370,manoj yadav,86870,81680,5190,4370
987654370,manoj yadav,77894,52970,24924,4370
987654370,manoj yadav,85143,64900,20243,4370
987654370,manoj yadav,103733,58280,45453,4370
987654370,manoj yadav,103601,101840,1761,4370
987654370,manoj yadav,101159,66800,34359,4370
987654370,manoj yadav,105515,88580,16935,4370
987654370,manoj yadav,129572,118980,10592,4370
987654370,manoj yadav,161098,110060,51038,4370
987654370,manoj yadav,97760,36830,60930,4370
987654370,manoj yadav,84736,70370,14366,4370
987654370,manoj yadav,77146,56480,20666,4370
987654370,manoj yadav,78125,57470,20655,4370
987654370,manoj yadav,80127,70650,9477,4370
987654370,manoj yadav,87992,87460,532,4370
987654370,manoj yadav,106516,82310,24206,4370
987654370,manoj yadav,102292,39210,63082,4370
987654370,manoj yadav,88894,83140,5754,4370
987654370,manoj yadav,95472,83180,12292,4370
987654370,manoj yadav,109200,56040,53160,4370
987654371,ram singh,128439,35770,92669,4371
987654371,ram singh,110179,54180,55999,4371
987654371,ram singh,80776,57320,23456,4371
987654371,ram singh,76937,66540,10397,4371
987654371,ram singh,80578,74470,6108,4371
987654371,ram singh,77311,30350,46961,4371
987654371,ram singh,85979,52070,33909,4371
987654371,ram singh,102336,54000,48336,4371
987654371,ram singh,109926,96220,13706,4371
987654371,ram singh,99872,74460,25412,4371
987654371,ram singh,99509,39670,59839,4371
987654371,ram singh,123500,99210,24290,4371
987654371,ram singh,150615,51820,98795,4371
987654371,ram singh,123808,35310,88498,4371
987654371,ram singh,119419,30880,88539,4371
987654371,ram singh,85033,53430,31603,4371
987654371,ram singh,76937,62190,14747,4371
987654371,ram singh,75012,70090,4922,4371
987654371,ram singh,85682,34430,51252,4371
987654371,ram singh,110597,67390,43207,4371
987654371,ram singh,101203,29860,71343,4371
987654371,ram singh,104052,32500,71552,4371
987654371,ram singh,99190,80280,18910,4371
987654371,ram singh,106516,51130,55386,4371
987654372,preetam kumar,124347,119910,4437,4372
987654372,preetam kumar,100961,70600,30361,4372
987654372,preetam kumar,97727,25180,72547,4372
987654372,preetam kumar,85495,32790,52705,4372
987654372,preetam kumar,90764,49750,41014,4372
987654372,preetam kumar,82393,42000,40393,4372
987654372,preetam kumar,99905,76030,23875,4372
987654372,preetam kumar,108342,40120,68222,4372
987654372,preetam kumar,105361,99640,5721,4372
987654372,preetam kumar,105559,44870,60689,4372
987654372,preetam kumar,110586,38170,72416,4372
987654372,preetam kumar,118825,73020,45805,4372
987654372,preetam kumar,150054,109270,40784,4372
987654372,preetam kumar,132388,58110,74278,4372
987654372,preetam kumar,115228,95610,19618,4372
987654372,preetam kumar,86540,75690,10850,4372
987654372,preetam kumar,88036,66910,21126,4372
987654372,preetam kumar,80028,58100,21928,4372
987654372,preetam kumar,85880,53250,32630,4372
987654372,preetam kumar,107396,28620,78776,4372
987654372,preetam kumar,100774,71070,29704,4372
987654372,preetam kumar,105460,86880,18580,4372
987654372,preetam kumar,97958,89460,8498,4372
987654372,preetam kumar,104096,86890,17206,4372
987654373,ram kumar,118154,96530,21624,4373
987654373,ram kumar,104041,101360,2681,4373
987654373,ram kumar,84274,29530,54744,4373
987654373,ram kumar,76277,47110,29167,4373
987654373,ram kumar,72361,50490,21871,4373
987654373,ram kumar,82195,61580,20615,4373
987654373,ram kumar,86298,74290,12008,4373
987654373,ram kumar,101313,48810,52503,4373
987654373,ram kumar,100774,76590,24184,4373
987654373,ram kumar,104459,51470,52989,4373
987654373,ram kumar,102061,37690,64371,4373
987654373,ram kumar,113798,83980,29818,4373
987654373,ram kumar,144026,111490,32536,4373
987654373,ram kumar,116339,42020,74319,4373
987654373,ram kumar,102369,82380,19989,4373
987654373,ram kumar,104855,50250,54605,4373
987654373,ram kumar,108023,68380,39643,4373
987654373,ram kumar,191612,136130,55482,4373
987654373,ram kumar,120574,75230,45344,4373
987654373,ram kumar,122829,31080,91749,4373
987654373,ram kumar,74726,45640,29086,4373
987654373,ram kumar,186431,86460,99971,4373
987654373,ram kumar,156357,39980,116377,4373
987654373,ram kumar,162407,75470,86937,4373
987654374,sarain,145929,84750,61179,4374
987654374,sarain,147920,64030,83890,4374
987654374,sarain,159261,103250,56011,4374
987654374,sarain,185353,117640,67713,4374
987654374,sarain,133290,37290,96000,4374
987654374,sarain,95659,32910,62749,4374
987654374,sarain,93173,68480,24693,4374
987654374,sarain,93360,85060,8300,4374
987654374,sarain,89730,83610,6120,4374
987654374,sarain,98057,31650,66407,4374
987654374,sarain,116064,87500,28564,4374
987654374,sarain,116647,82720,33927,4374
987654374,sarain,134038,56640,77398,4374
987654374,sarain,114249,91480,22769,4374
987654374,sarain,132960,95270,37690,4374
987654374,sarain,155246,98980,56266,4374
987654374,sarain,147414,66490,80924,4374
987654374,sarain,125370,40070,85300,4374
987654374,sarain,86705,67290,19415,4374
987654374,sarain,85979,84720,1259,4374
987654374,sarain,85935,64760,21175,4374
987654374,sarain,94339,84310,10029,4374
987654374,sarain,103414,81690,21724,4374
987654374,sarain,99861,28950,70911,4374
987654375,pankaj kumar,101896,58490,43406,4375
987654375,pankaj kumar,102160,90240,11920,4375
987654375,pankaj kumar,100543,50010,50533,4375
987654375,pankaj kumar,124721,120210,4511,4375
987654375,pankaj kumar,111807,103780,8027,4375
987654375,pankaj kumar,83977,71990,11987,4375
987654375,pankaj kumar,75496,30480,45016,4375
987654375,pankaj kumar,79973,59910,20063,4375
987654375,pankaj kumar,79049,45310,33739,4375
987654375,pankaj kumar,90731,66620,24111,4375
987654375,pankaj kumar,114183,52530,61653,4375
987654375,pankaj kumar,110047,33650,76397,4375
987654375,pankaj kumar,94372,70560,23812,4375
987654375,pankaj kumar,101676,90720,10956,4375
987654375,pankaj kumar,105856,58260,47596,4375
987654375,pankaj kumar,112313,90340,21973,4375
987654375,pankaj kumar,115789,61530,54259,4375
987654375,pankaj kumar,96792,57860,38932,4375
987654375,pankaj kumar,100081,61090,38991,4375
987654375,pankaj kumar,85880,40560,45320,4375
987654375,pankaj kumar,73989,66830,7159,4375
987654375,pankaj kumar,84175,38280,45895,4375
987654375,pankaj kumar,100048,74720,25328,4375
987654375,pankaj kumar,96968,67570,29398,4375
987654376,sheak shakir,83878,50540,33338,4376
987654376,sheak shakir,87706,39870,47836,4376
987654376,sheak shakir,92678,76120,16558,4376
987654376,sheak shakir,113204,71760,41444,4376
987654376,sheak shakir,102996,63690,39306,4376
987654376,sheak shakir,72592,59550,13042,4376
987654376,sheak shakir,68929,25400,43529,4376
987654376,sheak shakir,73307,28430,44877,4376
987654376,sheak shakir,77091,54990,22101,4376
987654376,sheak shakir,79687,61220,18467,4376
987654376,sheak shakir,106956,53480,53476,4376
987654376,sheak shakir,110762,104070,6692,4376
987654376,sheak shakir,100378,53550,46828,4376
987654376,sheak shakir,98673,32640,66033,4376
987654376,sheak shakir,108672,51390,57282,4376
987654376,sheak shakir,133829,95800,38029,4376
987654376,sheak shakir,98398,25260,73138,4376
987654376,sheak shakir,112324,101930,10394,4376
987654376,sheak shakir,110927,52520,58407,4376
987654376,sheak shakir,101885,58870,43015,4376
987654376,sheak shakir,124116,32410,91706,4376
987654376,sheak shakir,102094,36770,65324,4376
987654376,sheak shakir,105911,51360,54551,4376
987654376,sheak shakir,92997,63930,29067,4376
987654377,riyasat ali,99663,38690,60973,4377
987654377,riyasat ali,95791,41160,54631,4377
987654377,riyasat ali,109068,73190,35878,4377
987654377,riyasat ali,95021,75130,19891,4377
987654377,riyasat ali,77597,71900,5697,4377
987654377,riyasat ali,77267,57360,19907,4377
987654377,riyasat ali,73791,22870,50921,4377
987654377,riyasat ali,79808,38150,41658,4377
987654377,riyasat ali,87101,57140,29961,4377
987654377,riyasat ali,101027,75850,25177,4377
987654377,riyasat ali,112247,89470,22777,4377
987654377,riyasat ali,112907,105880,7027,4377
987654377,riyasat ali,103095,42430,60665,4377
987654377,riyasat ali,116790,40180,76610,4377
987654377,riyasat ali,131937,75970,55967,4377
987654377,riyasat ali,93151,26070,67081,4377
987654377,riyasat ali,76849,25790,51059,4377
987654377,riyasat ali,74913,45600,29313,4377
987654377,riyasat ali,90313,25600,64713,4377
987654377,riyasat ali,84186,26960,57226,4377
987654377,riyasat ali,99410,69520,29890,4377
987654377,riyasat ali,118220,100030,18190,4377
987654377,riyasat ali,128824,67730,61094,4377
987654377,riyasat ali,91193,41460,49733,4377
987654378,vinit katariya,91941,27090,64851,4378
987654378,vinit katariya,89697,69650,20047,4378
987654378,vinit katariya,111807,101480,10327,4378
987654378,vinit katariya,89257,80710,8547,4378
987654378,vinit katariya,72262,42910,29352,4378
987654378,vinit katariya,75606,37900,37706,4378
987654378,vinit katariya,72867,26520,46347,4378
987654378,vinit katariya,75837,74550,1287,4378
987654378,vinit katariya,95879,29160,66719,4378
987654378,vinit katariya,90764,22920,67844,4378
987654378,vinit katariya,102798,61140,41658,4378
987654378,vinit katariya,95912,87590,8322,4378
987654378,vinit katariya,110773,109950,823,4378
987654378,vinit katariya,117483,113670,3813,4378
987654378,vinit katariya,131123,90660,40463,4378
987654378,vinit katariya,100719,48210,52509,4378
987654378,vinit katariya,86342,76310,10032,4378
987654378,vinit katariya,82371,76830,5541,4378
987654378,vinit katariya,78796,62550,16246,4378
987654378,vinit katariya,83229,69470,13759,4378
987654378,vinit katariya,103568,97640,5928,4378
987654378,vinit katariya,97958,52790,45168,4378
987654378,vinit katariya,110905,67260,43645,4378
987654378,vinit katariya,116922,100970,15952,4378
987654379,sumit,147513,85330,62183,4379
987654379,sumit,118660,83070,35590,4379
987654379,sumit,122092,57670,64422,4379
987654379,sumit,78378,55380,22998,4379
987654379,sumit,70876,68200,2676,4379
987654379,sumit,75903,51360,24543,4379
987654379,sumit,69930,19830,50100,4379
987654379,sumit,64639,50370,14269,4379
987654379,sumit,77850,45870,31980,4379
987654379,sumit,83559,32350,51209,4379
987654379,sumit,90676,86830,3846,4379
987654379,sumit,89048,54320,34728,4379
987654379,sumit,94801,69930,24871,4379
987654379,sumit,102919,42860,60059,4379
987654379,sumit,128318,106820,21498,4379
987654379,sumit,82921,32560,50361,4379
987654379,sumit,78587,29710,48877,4379
987654379,sumit,73263,38700,34563,4379
987654379,sumit,71789,65540,6249,4379
987654379,sumit,72174,67710,4464,4379
987654379,sumit,87816,50370,37446,4379
987654379,sumit,87244,81030,6214,4379
987654379,sumit,92689,70600,22089,4379
987654379,sumit,97969,90220,7749,4379
987654380,arindra,100059,97330,2729,4380
987654380,arindra,106230,43330,62900,4380
987654380,arindra,145313,64090,81223,4380
987654380,arindra,113281,76570,36711,4380
987654380,arindra,106494,64750,41744,4380
987654380,arindra,90071,23200,66871,4380
987654380,arindra,90478,66170,24308,4380
987654380,arindra,92799,60120,32679,4380
987654380,arindra,101137,65090,36047,4380
987654380,arindra,96583,81480,15103,4380
987654380,arindra,103898,96270,7628,4380
987654380,arindra,105075,47660,57415,4380
987654380,arindra,103007,76180,26827,4380
987654380,arindra,107836,80180,27656,4380
987654380,arindra,144268,42880,101388,4380
987654380,arindra,107594,37100,70494,4380
987654380,arindra,91281,54330,36951,4380
987654380,arindra,84560,64630,19930,4380
987654380,arindra,79049,45440,33609,4380
987654380,arindra,83207,74120,9087,4380
987654380,arindra,98167,27240,70927,4380
987654380,arindra,92689,69620,23069,4380
987654380,arindra,105251,72100,33151,4380
987654380,arindra,95725,55380,40345,4380
987654381,kali charan,104987,35170,69817,4381
987654381,kali charan,116504,37990,78514,4381
987654381,kali charan,147964,42710,105254,4381
987654381,kali charan,127592,41770,85822,4381
987654381,kali charan,143784,79630,64154,4381
987654381,kali charan,98805,72140,26665,4381
987654381,kali charan,104107,38170,65937,4381
987654381,kali charan,107924,42910,65014,4381
987654381,kali charan,124303,35220,89083,4381
987654381,kali charan,109761,44010,65751,4381
987654381,kali charan,85187,27170,58017,4381
987654381,kali charan,77938,48910,29028,4381
987654381,kali charan,82096,32320,49776,4381
987654381,kali charan,107638,99720,7918,4381
987654381,kali charan,119463,89520,29943,4381
987654381,kali charan,99619,32140,67479,4381
987654381,kali charan,97309,77380,19929,4381
987654381,kali charan,103986,86620,17366,4381
987654381,kali charan,111081,61690,49391,4381
987654381,kali charan,134038,121060,12978,4381
987654381,kali charan,114469,89190,25279,4381
987654381,kali charan,116944,41590,75354,4381
987654381,kali charan,99938,99490,448,4381
987654381,kali charan,90005,71360,18645,4381
987654382,badshya khan,87145,75360,11785,4382
987654382,badshya khan,106923,62580,44343,4382
987654382,badshya khan,124765,109890,14875,4382
987654382,badshya khan,142816,79920,62896,4382
987654382,badshya khan,163650,82560,81090,4382
987654382,badshya khan,122620,86500,36120,4382
987654382,badshya khan,107352,64150,43202,4382
987654382,badshya khan,94603,89470,5133,4382
987654382,badshya khan,87915,26300,61615,4382
987654382,badshya khan,82536,59390,23146,4382
987654382,badshya khan,100906,81790,19116,4382
987654382,badshya khan,122598,68990,53608,4382
987654382,badshya khan,96319,52600,43719,4382
987654382,badshya khan,80237,49110,31127,4382
987654382,badshya khan,70370,64810,5560,4382
987654382,badshya khan,67774,37150,30624,4382
987654382,badshya khan,72229,60060,12169,4382
987654382,badshya khan,79071,69680,9391,4382
987654382,badshya khan,108991,64260,44731,4382
987654382,badshya khan,104492,102170,2322,4382
987654382,badshya khan,96484,50180,46304,4382
987654382,badshya khan,96858,54880,41978,4382
987654382,badshya khan,101698,63290,38408,4382
987654382,badshya khan,120453,54410,66043,4382
987654383,vikash,109915,79110,30805,4383
987654383,vikash,90984,85070,5914,4383
987654383,vikash,95692,65570,30122,4383
987654383,vikash,98222,43340,54882,4383
987654383,vikash,126822,101410,25412,4383
987654383,vikash,161439,139550,21889,4383
987654383,vikash,186090,86910,99180,4383
987654383,vikash,121234,86320,34914,4383
987654383,vikash,114271,84530,29741,4383
987654383,vikash,127108,42790,84318,4383
987654383,vikash,108705,107300,1405,4383
987654383,vikash,112170,89260,22910,4383
987654383,vikash,104206,37260,66946,4383
987654383,vikash,100719,89980,10739,4383
987654383,vikash,113391,101680,11711,4383
987654383,vikash,128153,114550,13603,4383
987654383,vikash,103986,91070,12916,4383
987654383,vikash,86419,25170,61249,4383
987654383,vikash,78312,55770,22542,4383
987654383,vikash,82822,43430,39392,4383
987654383,vikash,84516,55310,29206,4383
987654383,vikash,92425,69030,23395,4383
987654383,vikash,109376,53780,55596,4383
987654383,vikash,112775,110790,1985,4383
987654384,devinder chadda,101170,86090,15080,4384
987654384,devinder chadda,103007,35620,67387,4384
987654384,devinder chadda,108364,82400,25964,4384
987654384,devinder chadda,147282,51360,95922,4384
987654384,devinder chadda,116031,68790,47241,4384
987654384,devinder chadda,108683,58900,49783,4384
987654384,devinder chadda,117747,109160,8587,4384
987654384,devinder chadda,79896,55560,24336,4384
987654384,devinder chadda,79269,58890,20379,4384
987654384,devinder chadda,78818,78200,618,4384
987654384,devinder chadda,106868,85680,21188,4384
987654384,devinder chadda,116933,55040,61893,4384
987654384,devinder chadda,102413,31410,71003,4384
987654384,devinder chadda,98046,88270,9776,4384
987654384,devinder chadda,106989,89600,17389,4384
987654384,devinder chadda,144873,135740,9133,4384
987654384,devinder chadda,107407,81870,25537,4384
987654384,devinder chadda,88003,53990,34013,4384
987654384,devinder chadda,90709,23820,66889,4384
987654384,devinder chadda,87893,62770,25123,4384
987654384,devinder chadda,85880,43280,42600,4384
987654384,devinder chadda,98057,65460,32597,4384
987654384,devinder chadda,111125,96100,15025,4384
987654384,devinder chadda,109695,103940,5755,4384
987654385,aman,111862,104340,7522,4385
987654385,aman,111125,88670,22455,4385
987654385,aman,124963,42520,82443,4385
987654385,aman,153387,93400,59987,4385
987654385,aman,122433,106530,15903,4385
987654385,aman,102732,33830,68902,4385
987654385,aman,114029,50480,63549,4385
987654385,aman,83691,49210,34481,4385
987654385,aman,83229,27420,55809,4385
987654385,aman,81194,40950,40244,4385
987654385,aman,102633,34970,67663,4385
987654385,aman,107110,32310,74800,4385
987654385,aman,93756,92680,1076,4385
987654385,aman,101676,80620,21056,4385
987654385,aman,109827,98450,11377,4385
987654385,aman,128417,126200,2217,4385
987654385,aman,104085,92060,12025,4385
987654385,aman,86507,38850,47657,4385
987654385,aman,78048,65930,12118,4385
987654385,aman,71987,43650,28337,4385
987654385,aman,78411,43680,34731,4385
987654385,aman,85814,49350,36464,4385
987654385,aman,106989,75250,31739,4385
987654385,aman,115712,70410,45302,4385
987654386,mohan singh,104272,45170,59102,4386
987654386,mohan singh,97507,44550,52957,4386
987654386,mohan singh,110421,70250,40171,4386
987654386,mohan singh,133312,92790,40522,4386
987654386,mohan singh,113798,31070,82728,4386
987654386,mohan singh,91270,30060,61210,4386
987654386,mohan singh,90797,47130,43667,4386
987654386,mohan singh,109431,27660,81771,4386
987654386,mohan singh,62241,18460,43781,4386
987654386,mohan singh,52770,31610,21160,4386
987654386,mohan singh,58105,57530,575,4386
987654386,mohan singh,53309,21370,31939,4386
987654386,mohan singh,63033,31630,31403,4386
987654386,mohan singh,31892,9490,22402,4386
987654386,mohan singh,41924,17290,24634,4386
987654386,mohan singh,38382,26110,12272,4386
987654386,mohan singh,38239,18080,20159,4386
987654386,mohan singh,41000,14160,26840,4386
987654386,mohan singh,47391,19450,27941,4386
987654386,mohan singh,32145,29130,3015,4386
987654386,mohan singh,48722,39680,9042,4386
987654386,mohan singh,56345,20780,35565,4386
987654386,mohan singh,50482,26940,23542,4386
987654386,mohan singh,63418,34880,28538,4386
987654387,hemant,75177,30320,44857,4387
987654387,hemant,34554,22570,11984,4387
987654387,hemant,49910,42510,7400,4387
987654387,hemant,45125,12100,33025,4387
987654387,hemant,44872,14470,30402,4387
987654387,hemant,44311,31230,13081,4387
987654387,hemant,49668,21100,28568,4387
987654387,hemant,32849,26070,6779,4387
987654387,hemant,50614,33510,17104,4387
987654387,hemant,58765,49860,8905,4387
987654387,hemant,63924,18490,45434,4387
987654387,hemant,81777,65390,16387,4387
987654387,hemant,77025,67190,9835,4387
987654387,hemant,33938,22390,11548,4387
987654387,hemant,46445,34740,11705,4387
987654387,hemant,42551,16140,26411,4387
987654387,hemant,43750,19420,24330,4387
987654387,hemant,42199,12740,29459,4387
987654387,hemant,40131,33910,6221,4387
987654387,hemant,30803,11850,18953,4387
987654387,hemant,60184,31190,28994,4387
987654387,hemant,48535,45510,3025,4387
987654387,hemant,56565,38330,18235,4387
987654387,hemant,63924,44160,19764,4387
987654388,shivam,78697,51430,27267,4388
987654388,shivam,31012,11600,19412,4388
987654388,shivam,44850,20750,24100,4388
987654388,shivam,44597,17590,27007,4388
987654388,shivam,47666,29020,18646,4388
987654388,shivam,46533,33320,13213,4388
987654388,shivam,48766,24280,24486,4388
987654388,shivam,30880,21600,9280,4388
987654388,shivam,59403,26950,32453,4388
987654388,shivam,63319,35510,27809,4388
987654388,shivam,65640,17860,47780,4388
987654388,shivam,75837,23910,51927,4388
987654388,shivam,77674,38000,39674,4388
987654388,shivam,41396,12270,29126,4388
987654388,shivam,59865,34850,25015,4388
987654388,shivam,52374,49790,2584,4388
987654388,shivam,50383,28510,21873,4388
987654388,shivam,50394,27940,22454,4388
987654388,shivam,35863,9170,26693,4388
987654388,shivam,67543,17290,50253,4388
987654388,shivam,58446,48400,10046,4388
987654388,shivam,61537,17310,44227,4388
987654388,shivam,64727,20970,43757,4388
987654388,shivam,72152,43710,28442,4388
987654389,yash mittal,35775,24510,11265,4389
987654389,yash mittal,52902,17320,35582,4389
987654389,yash mittal,55399,16020,39379,4389
987654389,yash mittal,45444,33200,12244,4389
987654389,yash mittal,48744,28450,20294,4389
987654389,yash mittal,33454,30250,3204,4389
987654389,yash mittal,54321,34400,19921,4389
987654389,yash mittal,56334,30230,26104,4389
987654389,yash mittal,62593,33130,29463,4389
987654389,yash mittal,61768,39380,22388,4389
987654389,yash mittal,82811,70610,12201,4389
987654389,yash mittal,44443,32020,12423,4389
987654389,yash mittal,80237,34560,45677,4389
987654389,yash mittal,73582,60150,13432,4389
987654389,yash mittal,60118,37170,22948,4389
987654389,yash mittal,74572,65140,9432,4389
987654389,yash mittal,30187,17350,12837,4389
987654389,yash mittal,35379,13060,22319,4389
987654389,yash mittal,40824,40010,814,4389
987654389,yash mittal,45356,31050,14306,4389
987654389,yash mittal,37458,36920,538,4389
987654389,yash mittal,47897,44680,3217,4389
987654389,yash mittal,32387,19790,12597,4389
987654389,yash mittal,64562,57050,7512,4389
987654390,aakash,63154,40200,22954,4390
987654390,aakash,59084,52710,6374,4390
987654390,aakash,57665,34130,23535,4390
987654390,aakash,83944,68010,15934,4390
987654390,aakash,34598,20030,14568,4390
987654390,aakash,46797,22030,24767,4390
987654390,aakash,48260,28790,19470,4390
987654390,aakash,49151,46640,2511,4390
987654390,aakash,52550,19370,33180,4390
987654390,aakash,43431,38040,5391,4390
987654390,aakash,82800,53870,28930,4390
987654390,aakash,84835,83040,1795,4390
987654390,aakash,74913,20440,54473,4390
987654390,aakash,74429,61790,12639,4390
987654390,aakash,34554,18500,16054,4390
987654390,aakash,45191,40000,5191,4390
987654390,aakash,43310,36120,7190,4390
987654390,aakash,46258,44830,1428,4390
987654390,aakash,43959,23760,20199,4390
987654390,aakash,46731,43190,3541,4390
987654390,aakash,34411,26170,8241,4390
987654390,aakash,56400,42930,13470,4390
987654390,aakash,55663,35200,20463,4390
987654390,aakash,52506,47880,4626,4390
987654391,chandesh,62901,34830,28071,4391
987654391,chandesh,81018,59240,21778,4391
987654391,chandesh,34884,29600,5284,4391
987654391,chandesh,45719,18630,27089,4391
987654391,chandesh,40065,38190,1875,4391
987654391,chandesh,43024,28460,14564,4391
987654391,chandesh,47996,37240,10756,4391
987654391,chandesh,45323,27010,18313,4391
987654391,chandesh,33476,18040,15436,4391
987654391,chandesh,59392,50320,9072,4391
987654391,chandesh,49580,24180,25400,4391
987654391,chandesh,62934,31930,31004,4391
987654391,chandesh,64672,40630,24042,4391
987654391,chandesh,82789,72130,10659,4391
987654391,chandesh,36600,26940,9660,4391
987654391,chandesh,53837,22470,31367,4391
987654391,chandesh,43508,40540,2968,4391
987654391,chandesh,43376,28760,14616,4391
987654391,chandesh,44564,36170,8394,4391
987654391,chandesh,41693,31390,10303,4391
987654391,chandesh,34026,19790,14236,4391
987654391,chandesh,58534,45280,13254,4391
987654391,chandesh,54101,48300,5801,4391
987654391,chandesh,50878,37800,13078,4391
987654392,sumit mitra,61526,22360,39166,4392
987654392,sumit mitra,71646,27800,43846,4392
987654392,sumit mitra,32035,27390,4645,4392
987654392,sumit mitra,44993,29520,15473,4392
987654392,sumit mitra,40549,18690,21859,4392
987654392,sumit mitra,42353,21680,20673,4392
987654392,sumit mitra,44916,22480,22436,4392
987654392,sumit mitra,42254,42240,14,4392
987654392,sumit mitra,36600,15410,21190,4392
987654392,sumit mitra,58028,55120,2908,4392
987654392,sumit mitra,57995,55390,2605,4392
987654392,sumit mitra,55454,45330,10124,4392
987654392,sumit mitra,66685,59840,6845,4392
987654392,sumit mitra,81623,62030,19593,4392
987654392,sumit mitra,36952,32860,4092,4392
987654392,sumit mitra,72185,57710,14475,4392
987654392,sumit mitra,59425,58890,535,4392
987654392,sumit mitra,66927,38940,27987,4392
987654392,sumit mitra,55949,17940,38009,4392
987654392,sumit mitra,70040,35540,34500,4392
987654392,sumit mitra,33322,8540,24782,4392
987654392,sumit mitra,40901,28720,12181,4392
987654392,sumit mitra,40450,15060,25390,4392
987654392,sumit mitra,45466,41500,3966,4392
987654393,supriyal sen,39900,29450,10450,4393
987654393,supriyal sen,44355,42340,2015,4393
987654393,supriyal sen,32431,13850,18581,4393
987654393,supriyal sen,60932,26670,34262,4393
987654393,supriyal sen,56741,42190,14551,4393
987654393,supriyal sen,62879,53410,9469,4393
987654393,supriyal sen,60690,31030,29660,4393
987654393,supriyal sen,69072,60240,8832,4393
987654393,supriyal sen,34928,25500,9428,4393
987654393,supriyal sen,57786,45310,12476,4393
987654393,supriyal sen,55553,20310,35243,4393
987654393,supriyal sen,57346,45100,12246,4393
987654393,supriyal sen,64507,18840,45667,4393
987654393,supriyal sen,71129,34210,36919,4393
987654393,supriyal sen,38327,22810,15517,4393
987654393,supriyal sen,47083,18610,28473,4393
987654393,supriyal sen,28724,19970,8754,4393
987654393,supriyal sen,55564,31700,23864,4393
987654393,supriyal sen,57533,39030,18503,4393
987654393,supriyal sen,43970,18660,25310,4393
987654393,supriyal sen,37007,25570,11437,4393
987654393,supriyal sen,87882,83290,4592,4393
987654393,supriyal sen,102347,46490,55857,4393
987654393,supriyal sen,56642,52590,4052,4393
987654394,gajender singh ,83174,69040,14134,4394
987654394,gajender singh ,78521,73660,4861,4394
987654394,gajender singh ,82503,54530,27973,4394
987654394,gajender singh ,85033,67640,17393,4394
987654394,gajender singh ,103887,46770,57117,4394
987654394,gajender singh ,44982,34810,10172,4394
987654394,gajender singh ,55949,42690,13259,4394
987654394,gajender singh ,48414,19250,29164,4394
987654394,gajender singh ,52165,40680,11485,4394
987654394,gajender singh ,54310,53180,1130,4394
987654394,gajender singh ,64529,22610,41919,4394
987654394,gajender singh ,49910,23250,26660,4394
987654394,gajender singh ,91600,29870,61730,4394
987654394,gajender singh ,70161,35250,34911,4394
987654394,gajender singh ,76046,71230,4816,4394
987654394,gajender singh ,78092,68490,9602,4394
987654394,gajender singh ,84098,37810,46288,4394
987654394,gajender singh ,56235,45730,10505,4394
987654394,gajender singh ,78928,58490,20438,4394
987654394,gajender singh ,70392,64260,6132,4394
987654394,gajender singh ,64485,61720,2765,4394
987654394,gajender singh ,76794,47200,29594,4394
987654394,gajender singh ,86727,65030,21697,4394
987654394,gajender singh ,39262,31410,7852,4394
987654395,pooran chand sharma,50251,29900,20351,4395
987654395,pooran chand sharma,61856,21720,40136,4395
987654395,pooran chand sharma,52297,19960,32337,4395
987654395,pooran chand sharma,57500,48920,8580,4395
987654395,pooran chand sharma,38140,25250,12890,4395
987654395,pooran chand sharma,62362,22540,39822,4395
987654395,pooran chand sharma,59744,45420,14324,4395
987654395,pooran chand sharma,61911,51790,10121,4395
987654395,pooran chand sharma,69072,32140,36932,4395
987654395,pooran chand sharma,67257,61450,5807,4395
987654395,pooran chand sharma,41330,15330,26000,4395
987654395,pooran chand sharma,62142,52190,9952,4395
987654395,pooran chand sharma,61669,38250,23419,4395
987654395,pooran chand sharma,74242,33440,40802,4395
987654395,pooran chand sharma,70117,29110,41007,4395
987654395,pooran chand sharma,86639,24970,61669,4395
987654395,pooran chand sharma,42969,32570,10399,4395
987654395,pooran chand sharma,62296,32500,29796,4395
987654395,pooran chand sharma,48601,47870,731,4395
987654395,pooran chand sharma,46555,32250,14305,4395
987654395,pooran chand sharma,46280,26430,19850,4395
987654395,pooran chand sharma,31551,23470,8081,4395
987654395,pooran chand sharma,53408,14780,38628,4395
987654395,pooran chand sharma,51549,22960,28589,4395
987654396,irfan,49074,47740,1334,4396
987654396,irfan,56301,24950,31351,4396
987654396,irfan,69699,17970,51729,4396
987654396,irfan,36886,30650,6236,4396
987654396,irfan,49932,38050,11882,4396
987654396,irfan,48326,34350,13976,4396
987654396,irfan,49470,24580,24890,4396
987654396,irfan,50647,37980,12667,4396
987654396,irfan,51681,13130,38551,4396
987654396,irfan,36039,27380,8659,4396
987654396,irfan,64144,34030,30114,4396
987654396,irfan,55806,18000,37806,4396
987654396,irfan,63638,52830,10808,4396
987654396,irfan,65871,58620,7251,4396
987654396,irfan,80886,41690,39196,4396
987654396,irfan,46016,17670,28346,4396
987654396,irfan,72075,27000,45075,4396
987654396,irfan,74968,42750,32218,4396
987654396,irfan,80600,74250,6350,4396
987654396,irfan,70447,54590,15857,4396
987654396,irfan,31672,21860,9812,4396
987654396,irfan,49811,40770,9041,4396
987654396,irfan,43827,32080,11747,4396
987654396,irfan,43541,17150,26391,4396
987654397,azaruddin,53936,36920,17016,4397
987654397,azaruddin,45521,32790,12731,4397
987654397,azaruddin,33949,10360,23589,4397
987654397,azaruddin,56741,25640,31101,4397
987654397,azaruddin,59172,20780,38392,4397
987654397,azaruddin,58358,50270,8088,4397
987654397,azaruddin,65497,16810,48687,4397
987654397,azaruddin,75166,26630,48536,4397
987654397,azaruddin,34741,26680,8061,4397
987654397,azaruddin,50218,17320,32898,4397
987654397,azaruddin,48095,29150,18945,4397
987654397,azaruddin,43101,11830,31271,4397
987654397,azaruddin,47127,36470,10657,4397
987654397,azaruddin,48909,15580,33329,4397
987654397,azaruddin,32662,27920,4742,4397
987654397,azaruddin,62142,60310,1832,4397
987654397,azaruddin,61592,50830,10762,4397
987654397,azaruddin,63231,22980,40251,4397
987654397,azaruddin,65354,52050,13304,4397
987654397,azaruddin,83526,54740,28786,4397
987654397,azaruddin,36182,9100,27082,4397
987654397,azaruddin,56642,31700,24942,4397
987654397,azaruddin,43662,18450,25212,4397
987654397,azaruddin,49217,14570,34647,4397
987654398,mukul yadav,41528,36770,4758,4398
987654398,mukul yadav,47710,33760,13950,4398
987654398,mukul yadav,31122,15810,15312,4398
987654398,mukul yadav,55212,24580,30632,4398
987654398,mukul yadav,53419,46830,6589,4398
987654398,mukul yadav,58974,44370,14604,4398
987654398,mukul yadav,57379,21050,36329,4398
987654398,mukul yadav,70766,38220,32546,4398
987654398,mukul yadav,32090,13410,18680,4398
987654398,mukul yadav,45345,38990,6355,4398
987654398,mukul yadav,43310,22260,21050,4398
987654398,mukul yadav,45763,37790,7973,4398
987654398,mukul yadav,45620,45030,590,4398
987654398,mukul yadav,50152,40200,9952,4398
987654398,mukul yadav,33333,31760,1573,4398
987654398,mukul yadav,58941,17610,41331,4398
987654398,mukul yadav,57841,32720,25121,4398
987654398,mukul yadav,58490,40390,18100,4398
987654398,mukul yadav,61801,18590,43211,4398
987654398,mukul yadav,72130,59790,12340,4398
987654398,mukul yadav,35291,24310,10981,4398
987654398,mukul yadav,65321,59900,5421,4398
987654398,mukul yadav,65343,28190,37153,4398
987654398,mukul yadav,61559,21340,40219,4398
987654399,pooran chand sharma,62318,36140,26178,4399
987654399,pooran chand sharma,67103,44140,22963,4399
987654399,pooran chand sharma,30561,9670,20891,4399
987654399,pooran chand sharma,45488,37080,8408,4399
987654399,pooran chand sharma,46610,22420,24190,4399
987654399,pooran chand sharma,47105,34570,12535,4399
987654399,pooran chand sharma,46698,18330,28368,4399
987654399,pooran chand sharma,47336,43140,4196,4399
987654399,pooran chand sharma,36677,35080,1597,4399
987654399,pooran chand sharma,61482,22400,39082,4399
987654399,pooran chand sharma,59920,50300,9620,4399
987654399,pooran chand sharma,64177,24810,39367,4399
987654399,pooran chand sharma,75221,27970,47251,4399
987654399,pooran chand sharma,73703,32540,41163,4399
987654399,pooran chand sharma,33674,30900,2774,4399
987654399,pooran chand sharma,50669,18050,32619,4399
987654399,pooran chand sharma,42793,21910,20883,4399
987654399,pooran chand sharma,49173,21720,27453,4399
987654399,pooran chand sharma,46929,31390,15539,4399
987654399,pooran chand sharma,51670,34280,17390,4399
987654399,pooran chand sharma,37557,29410,8147,4399
987654399,pooran chand sharma,63693,44950,18743,4399
987654399,pooran chand sharma,67191,60060,7131,4399
987654399,pooran chand sharma,69248,63390,5858,4399
987654400,manoj,83053,38870,44183,4400
987654400,manoj,84362,81430,2932,4400
987654400,manoj,36853,24350,12503,4400
987654400,manoj,52726,15290,37436,4400
987654400,manoj,45213,32670,12543,4400
987654400,manoj,47369,16360,31009,4400
987654400,manoj,43398,16270,27128,4400
987654400,manoj,51659,43450,8209,4400
987654400,manoj,34103,23270,10833,4400
987654400,manoj,62351,23740,38611,4400
987654400,manoj,56983,32410,24573,4400
987654400,manoj,68434,20120,48314,4400
987654400,manoj,70799,58750,12049,4400
987654400,manoj,77828,71330,6498,4400
987654400,manoj,34961,22600,12361,4400
987654400,manoj,60151,30240,29911,4400
987654400,manoj,50086,15620,34466,4400
987654400,manoj,54651,34490,20161,4400
987654400,manoj,57049,52920,4129,4400
987654400,manoj,25985,10010,15975,4400
987654400,manoj,73318,49870,23448,4400
987654400,manoj,59579,55820,3759,4400
987654400,manoj,64815,29590,35225,4400
987654400,manoj,74792,62010,12782,4400
987654401,sanjay charee,89301,22350,66951,4401
987654401,sanjay charee,37898,31800,6098,4401
987654401,sanjay charee,67961,61310,6651,4401
987654401,sanjay charee,55245,48180,7065,4401
987654401,sanjay charee,46049,23720,22329,4401
987654401,sanjay charee,58094,22150,35944,4401
987654401,sanjay charee,34895,29490,5405,4401
987654401,sanjay charee,58644,16550,42094,4401
987654401,sanjay charee,66619,56550,10069,4401
987654401,sanjay charee,65475,31870,33605,4401
987654401,sanjay charee,67103,25540,41563,4401
987654401,sanjay charee,80765,64270,16495,4401
987654401,sanjay charee,33575,27200,6375,4401
987654401,sanjay charee,53408,49550,3858,4401
987654401,sanjay charee,46951,17740,29211,4401
987654401,sanjay charee,47479,24640,22839,4401
987654401,sanjay charee,45906,42500,3406,4401
987654401,sanjay charee,51153,32300,18853,4401
987654401,sanjay charee,40978,24830,16148,4401
987654401,sanjay charee,60954,31870,29084,4401
987654401,sanjay charee,59777,36250,23527,4401
987654401,sanjay charee,66883,24330,42553,4401
987654401,sanjay charee,69424,19930,49494,4401
987654401,sanjay charee,85022,22180,62842,4401
987654402,raja babu,40901,31090,9811,4402
987654402,raja babu,76475,21670,54805,4402
987654402,raja babu,84890,80580,4310,4402
987654402,raja babu,68676,50840,17836,4402
987654402,raja babu,86914,67340,19574,4402
987654402,raja babu,33773,32540,1233,4402
987654402,raja babu,47831,41620,6211,4402
987654402,raja babu,51978,39290,12688,4402
987654402,raja babu,47050,27980,19070,4402
987654402,raja babu,55091,48940,6151,4402
987654402,raja babu,48645,25870,22775,4402
987654402,raja babu,83878,40380,43498,4402
987654402,raja babu,80567,48120,32447,4402
987654402,raja babu,86870,33720,53150,4402
987654402,raja babu,90324,66070,24254,4402
987654402,raja babu,36930,33850,3080,4402
987654402,raja babu,53859,35720,18139,4402
987654402,raja babu,44927,28860,16067,4402
987654402,raja babu,46236,44700,1536,4402
987654402,raja babu,52374,31780,20594,4402
987654402,raja babu,52319,19090,33229,4402
987654402,raja babu,36765,19140,17625,4402
987654402,raja babu,64254,34230,30024,4402
987654402,raja babu,63770,33340,30430,4402
987654403,pawan,73615,36200,37415,4403
987654403,pawan,81337,65770,15567,4403
987654403,pawan,93448,49100,44348,4403
987654403,pawan,32728,18320,14408,4403
987654403,pawan,53881,38960,14921,4403
987654403,pawan,43057,26340,16717,4403
987654403,pawan,49173,48950,223,4403
987654403,pawan,47501,36330,11171,4403
987654403,pawan,47963,15560,32403,4403
987654403,pawan,32816,12180,20636,4403
987654403,pawan,60767,29530,31237,4403
987654403,pawan,52583,44780,7803,4403
987654403,pawan,59007,55330,3677,4403
987654403,pawan,76343,52500,23843,4403
987654403,pawan,80402,45220,35182,4403
987654403,pawan,36094,30430,5664,4403
987654403,pawan,51439,28320,23119,4403
987654403,pawan,47281,17090,30191,4403
987654403,pawan,52946,23310,29636,4403
987654403,pawan,46544,13750,32794,4403
987654403,pawan,49646,31840,17806,4403
987654403,pawan,35489,28560,6929,4403
987654403,pawan,65508,57130,8378,4403
987654403,pawan,62263,32940,29323,4403
987654404,sandeep,69391,61020,8371,4404
987654404,sandeep,69479,38820,30659,4404
987654404,sandeep,98442,63650,34792,4404
987654404,sandeep,38492,14890,23602,4404
987654404,sandeep,57665,31110,26555,4404
987654404,sandeep,44575,33020,11555,4404
987654404,sandeep,45301,27270,18031,4404
987654404,sandeep,45752,21690,24062,4404
987654404,sandeep,50207,18670,31537,4404
987654404,sandeep,32673,30160,2513,4404
987654404,sandeep,56147,50820,5327,4404
987654404,sandeep,58952,51700,7252,4404
987654404,sandeep,61152,39640,21512,4404
987654404,sandeep,64617,56820,7797,4404
987654404,sandeep,79478,26840,52638,4404
987654404,sandeep,33674,9260,24414,4404
987654404,sandeep,54398,33020,21378,4404
987654404,sandeep,50284,28000,22284,4404
987654404,sandeep,50735,35770,14965,4404
987654404,sandeep,49965,30940,19025,4404
987654404,sandeep,48161,39890,8271,4404
987654404,sandeep,38536,30440,8096,4404
987654404,sandeep,64936,45660,19276,4404
987654404,sandeep,56928,25730,31198,4404
987654405,rajkumar chawla,66267,52910,13357,4405
987654405,rajkumar chawla,69622,18900,50722,4405
987654405,rajkumar chawla,85308,85030,278,4405
987654405,rajkumar chawla,36556,21900,14656,4405
987654405,rajkumar chawla,55685,16910,38775,4405
987654405,rajkumar chawla,48458,17940,30518,4405
987654405,rajkumar chawla,46038,21990,24048,4405
987654405,rajkumar chawla,45114,25250,19864,4405
987654405,rajkumar chawla,44608,12740,31868,4405
987654405,rajkumar chawla,30011,28560,1451,4405
987654405,rajkumar chawla,62956,35180,27776,4405
987654405,rajkumar chawla,52385,48840,3545,4405
987654405,rajkumar chawla,59656,36390,23266,4405
987654405,rajkumar chawla,64298,27500,36798,4405
987654405,rajkumar chawla,73285,33100,40185,4405
987654405,rajkumar chawla,34631,31650,2981,4405
987654405,rajkumar chawla,50273,23110,27163,4405
987654405,rajkumar chawla,46500,29110,17390,4405
987654405,rajkumar chawla,44168,35460,8708,4405
987654405,rajkumar chawla,42100,12480,29620,4405
987654405,rajkumar chawla,50394,35950,14444,4405
987654405,rajkumar chawla,32684,30120,2564,4405
987654405,rajkumar chawla,67455,51850,15605,4405
987654405,rajkumar chawla,55278,49890,5388,4405
987654406,parvesh,64914,26520,38394,4406
987654406,parvesh,68236,30140,38096,4406
987654406,parvesh,84813,83340,1473,4406
987654406,parvesh,33421,33020,401,4406
987654406,parvesh,53342,43670,9672,4406
987654406,parvesh,52638,50310,2328,4406
987654406,parvesh,30209,20410,9799,4406
987654406,parvesh,76860,31170,45690,4406
987654406,parvesh,40967,35550,5417,4406
987654406,parvesh,54145,29130,25015,4406
987654406,parvesh,38019,26590,11429,4406
987654406,parvesh,109134,27600,81534,4406
987654406,parvesh,60844,30320,30524,4406
987654406,parvesh,97507,91040,6467,4406
987654406,parvesh,91281,29280,62001,4406
987654406,parvesh,87618,33800,53818,4406
987654406,parvesh,99531,40760,58771,4406
987654406,parvesh,122609,48830,73779,4406
987654406,parvesh,64815,31710,33105,4406
987654406,parvesh,80512,76960,3552,4406
987654406,parvesh,73967,21410,52557,4406
987654406,parvesh,71558,63320,8238,4406
987654406,parvesh,81678,66650,15028,4406
987654406,parvesh,67070,27740,39330,4406
987654407,mohd ataullah,48887,45360,3527,4407
987654407,mohd ataullah,87431,86570,861,4407
987654407,mohd ataullah,106395,59890,46505,4407
987654407,mohd ataullah,93921,93800,121,4407
987654407,mohd ataullah,101082,53380,47702,4407
987654407,mohd ataullah,120992,58620,62372,4407
987654407,mohd ataullah,58765,19570,39195,4407
987654407,mohd ataullah,92084,90910,1174,4407
987654407,mohd ataullah,74088,48710,25378,4407
987654407,mohd ataullah,71217,46910,24307,4407
987654407,mohd ataullah,68126,27850,40276,4407
987654407,mohd ataullah,78191,54910,23281,4407
987654407,mohd ataullah,48832,25110,23722,4407
987654407,mohd ataullah,90225,29760,60465,4407
987654407,mohd ataullah,96374,82910,13464,4407
987654407,mohd ataullah,100774,69260,31514,4407
987654407,mohd ataullah,93338,32520,60818,4407
987654407,mohd ataullah,47314,28900,18414,4407
987654407,mohd ataullah,70755,29260,41495,4407
987654407,mohd ataullah,61625,45520,16105,4407
987654407,mohd ataullah,63605,28610,34995,4407
987654407,mohd ataullah,65827,35830,29997,4407
987654407,mohd ataullah,72086,41570,30516,4407
987654407,mohd ataullah,47204,31140,16064,4407
987654408,neeraj kumar,76068,52880,23188,4408
987654408,neeraj kumar,88597,66590,22007,4408
987654408,neeraj kumar,82041,39210,42831,4408
987654408,neeraj kumar,89631,59290,30341,4408
987654408,neeraj kumar,110905,91120,19785,4408
987654408,neeraj kumar,48700,37950,10750,4408
987654408,neeraj kumar,80369,23670,56699,4408
987654408,neeraj kumar,85495,83220,2275,4408
987654408,neeraj kumar,59436,27090,32346,4408
987654408,neeraj kumar,60536,28610,31926,4408
987654408,neeraj kumar,34785,19760,15025,4408
987654408,neeraj kumar,70370,49900,20470,4408
987654408,neeraj kumar,65805,43640,22165,4408
987654408,neeraj kumar,69105,64360,4745,4408
987654408,neeraj kumar,70722,57160,13562,4408
987654408,neeraj kumar,89015,76040,12975,4408
987654408,neeraj kumar,37601,18090,19511,4408
987654408,neeraj kumar,62186,43220,18966,4408
987654408,neeraj kumar,63022,49930,13092,4408
987654408,neeraj kumar,65981,65980,1,4408
987654408,neeraj kumar,69688,48650,21038,4408
987654408,neeraj kumar,67180,64710,2470,4408
987654408,neeraj kumar,47589,25510,22079,4408
987654408,neeraj kumar,80732,44520,36212,4408
987654409,jamil khan,70337,44950,25387,4409
987654409,jamil khan,81601,50350,31251,4409
987654409,jamil khan,85000,29550,55450,4409
987654409,jamil khan,99113,81160,17953,4409
987654409,jamil khan,44256,15400,28856,4409
987654409,jamil khan,78070,29550,48520,4409
987654409,jamil khan,79709,75000,4709,4409
987654409,jamil khan,76563,67140,9423,4409
987654409,jamil khan,81128,30750,50378,4409
987654409,jamil khan,39735,24490,15245,4409
987654409,jamil khan,78928,30370,48558,4409
987654409,jamil khan,61449,44020,17429,4409
987654409,jamil khan,73659,66700,6959,4409
987654409,jamil khan,83603,62690,20913,4409
987654409,jamil khan,93162,87050,6112,4409
987654409,jamil khan,39691,36740,2951,4409
987654409,jamil khan,59744,42110,17634,4409
987654409,jamil khan,60811,31370,29441,4409
987654409,jamil khan,55223,50240,4983,4409
987654409,jamil khan,60008,41170,18838,4409
987654409,jamil khan,61955,21890,40065,4409
987654409,jamil khan,37568,28230,9338,4409
987654409,jamil khan,80490,55690,24800,4409
987654409,jamil khan,74088,62710,11378,4409
987654410,yogita,81854,23130,58724,4410
987654410,yogita,80017,74270,5747,4410
987654410,yogita,90357,58030,32327,4410
987654410,yogita,38195,26200,11995,4410
987654410,yogita,67268,17540,49728,4410
987654410,yogita,61284,32270,29014,4410
987654410,yogita,69622,23660,45962,4410
987654410,yogita,65420,18120,47300,4410
987654410,yogita,71943,41900,30043,4410
987654410,yogita,43299,43060,239,4410
987654410,yogita,95901,38880,57021,4410
987654410,yogita,70062,37630,32432,4410
987654410,yogita,70953,67670,3283,4410
987654410,yogita,77421,38850,38571,4410
987654410,yogita,85176,45180,39996,4410
987654410,yogita,40098,34030,6068,4410
987654410,yogita,64463,19990,44473,4410
987654410,yogita,59095,30440,28655,4410
987654410,yogita,62615,40840,21775,4410
987654410,yogita,59381,18540,40841,4410
987654410,yogita,65343,43150,22193,4410
987654410,yogita,38481,26760,11721,4410
987654410,yogita,70260,17630,52630,4410
987654410,yogita,68467,27040,41427,4410
987654411,rijul aggarwal,79819,37860,41959,4411
987654411,rijul aggarwal,69952,23820,46132,4411
987654411,rijul aggarwal,82184,76590,5594,4411
987654411,rijul aggarwal,40703,17880,22823,4411
987654411,rijul aggarwal,62329,36470,25859,4411
987654411,rijul aggarwal,60470,31520,28950,4411
987654411,rijul aggarwal,62824,23500,39324,4411
987654411,rijul aggarwal,59216,50730,8486,4411
987654411,rijul aggarwal,67224,58340,8884,4411
987654411,rijul aggarwal,42639,35850,6789,4411
987654411,rijul aggarwal,78147,54650,23497,4411
987654411,rijul aggarwal,83834,61850,21984,4411
987654411,rijul aggarwal,98431,75390,23041,4411
987654411,rijul aggarwal,80215,47240,32975,4411
987654411,rijul aggarwal,86540,44290,42250,4411
987654411,rijul aggarwal,37095,36030,1065,4411
987654411,rijul aggarwal,59150,32780,26370,4411
987654411,rijul aggarwal,57313,19980,37333,4411
987654411,rijul aggarwal,62802,45690,17112,4411
987654411,rijul aggarwal,62846,16360,46486,4411
987654411,rijul aggarwal,67092,42110,24982,4411
987654411,rijul aggarwal,42067,27480,14587,4411
987654411,rijul aggarwal,80160,49380,30780,4411
987654411,rijul aggarwal,72416,64880,7536,4411
987654412,mohd shakib,76123,42520,33603,4412
987654412,mohd shakib,83174,54790,28384,4412
987654412,mohd shakib,93503,39520,53983,4412
987654412,mohd shakib,46038,26470,19568,4412
987654412,mohd shakib,72405,40810,31595,4412
987654412,mohd shakib,63836,60440,3396,4412
987654412,mohd shakib,63495,26720,36775,4412
987654412,mohd shakib,63319,27430,35889,4412
987654412,mohd shakib,78070,56140,21930,4412
987654412,mohd shakib,43112,37380,5732,4412
987654412,mohd shakib,74033,48790,25243,4412
987654412,mohd shakib,75661,30160,45501,4412
987654412,mohd shakib,82536,53880,28656,4412
987654412,mohd shakib,87079,72710,14369,4412
987654412,mohd shakib,109134,81890,27244,4412
987654412,mohd shakib,49140,24260,24880,4412
987654412,mohd shakib,81887,53540,28347,4412
987654412,mohd shakib,65948,35350,30598,4412
987654412,mohd shakib,65398,27320,38078,4412
987654412,mohd shakib,54442,20160,34282,4412
987654412,mohd shakib,70414,51090,19324,4412
987654412,mohd shakib,49591,13690,35901,4412
987654412,mohd shakib,80215,21110,59105,4412
987654412,mohd shakib,69358,27510,41848,4412
987654413,rahul kumar,76805,72020,4785,4413
987654413,rahul kumar,80567,59750,20817,4413
987654413,rahul kumar,88025,74450,13575,4413
987654413,rahul kumar,43541,23000,20541,4413
987654413,rahul kumar,70920,64050,6870,4413
987654413,rahul kumar,60272,38450,21822,4413
987654413,rahul kumar,67279,54620,12659,4413
987654413,rahul kumar,68104,60340,7764,4413
987654413,rahul kumar,73439,71190,2249,4413
987654413,rahul kumar,48007,37120,10887,4413
987654413,rahul kumar,85385,46200,39185,4413
987654413,rahul kumar,74660,63050,11610,4413
987654413,rahul kumar,78598,33840,44758,4413
987654413,rahul kumar,83273,50840,32433,4413
987654413,rahul kumar,78785,71450,7335,4413
987654413,rahul kumar,47182,38220,8962,4413
987654413,rahul kumar,104811,57830,46981,4413
987654413,rahul kumar,72614,67770,4844,4413
987654413,rahul kumar,72361,39680,32681,4413
987654413,rahul kumar,71668,24190,47478,4413
987654413,rahul kumar,85946,55270,30676,4413
987654413,rahul kumar,45180,13010,32170,4413
987654413,rahul kumar,70447,59690,10757,4413
987654413,rahul kumar,68819,34450,34369,4413
987654414,rajender,60558,28510,32048,4414
987654414,rajender,77663,59960,17703,4414
987654414,rajender,42122,41410,712,4414
987654414,rajender,80886,55360,25526,4414
987654414,rajender,76002,59310,16692,4414
987654414,rajender,79489,70620,8869,4414
987654414,rajender,79049,47860,31189,4414
987654414,rajender,92359,87040,5319,4414
987654414,rajender,45114,23570,21544,4414
987654414,rajender,69985,33970,36015,4414
987654414,rajender,78653,73570,5083,4414
987654414,rajender,72471,49940,22531,4414
987654414,rajender,65178,64010,1168,4414
987654414,rajender,39900,26150,13750,4414
987654414,rajender,89884,50950,38934,4414
987654414,rajender,98453,95330,3123,4414
987654414,rajender,107990,77150,30840,4414
987654414,rajender,89048,31800,57248,4414
987654414,rajender,36886,28850,8036,4414
987654414,rajender,72658,22940,49718,4414
987654414,rajender,68412,65550,2862,4414
987654414,rajender,71734,22080,49654,4414
987654414,rajender,83053,33290,49763,4414
987654414,rajender,89180,57020,32160,4414
987654415,suraj,45906,26100,19806,4415
987654415,suraj,64672,52090,12582,4415
987654415,suraj,56796,41870,14926,4415
987654415,suraj,63418,43450,19968,4415
987654415,suraj,62131,43030,19101,4415
987654415,suraj,62593,42030,20563,4415
987654415,suraj,34411,32750,1661,4415
987654415,suraj,71800,44930,26870,4415
987654415,suraj,70359,45440,24919,4415
987654415,suraj,73175,39860,33315,4415
987654415,suraj,84516,58870,25646,4415
987654415,suraj,86793,54170,32623,4415
987654415,suraj,36347,17280,19067,4415
987654415,suraj,63858,44520,19338,4415
987654415,suraj,59029,41720,17309,4415
987654415,suraj,66806,38690,28116,4415
987654415,suraj,77388,56570,20818,4415
987654415,suraj,57819,50570,7249,4415
987654415,suraj,112588,59600,52988,4415
987654415,suraj,91336,74480,16856,4415
987654415,suraj,91226,75400,15826,4415
987654415,suraj,91215,62540,28675,4415
987654415,suraj,39482,15650,23832,4415
987654415,suraj,74275,58230,16045,4415
987654416,rizwan,69765,19680,50085,4416
987654416,rizwan,82646,39880,42766,4416
987654416,rizwan,72713,27190,45523,4416
987654416,rizwan,87057,49210,37847,4416
987654416,rizwan,41330,15550,25780,4416
987654416,rizwan,64298,27250,37048,4416
987654416,rizwan,62747,51440,11307,4416
987654416,rizwan,56499,33190,23309,4416
987654416,rizwan,61449,31910,29539,4416
987654416,rizwan,62560,57010,5550,4416
987654416,rizwan,38030,30220,7810,4416
987654416,rizwan,73010,24010,49000,4416
987654416,rizwan,75617,39240,36377,4416
987654416,rizwan,79753,69550,10203,4416
987654416,rizwan,88707,46340,42367,4416
987654416,rizwan,94636,52820,41816,4416
987654416,rizwan,46907,34810,12097,4416
987654416,rizwan,74385,64880,9505,4416
987654416,rizwan,71844,22040,49804,4416
987654416,rizwan,58160,39240,18920,4416
987654416,rizwan,60261,15720,44541,4416
987654416,rizwan,62340,49920,12420,4416
987654416,rizwan,37513,23360,14153,4416
987654416,rizwan,74836,68100,6736,4416
987654417,sandeep,68852,67650,1202,4417
987654417,sandeep,71965,20210,51755,4417
987654417,sandeep,71030,37550,33480,4417
987654417,sandeep,90962,69910,21052,4417
987654417,sandeep,41649,31780,9869,4417
987654417,sandeep,57445,44780,12665,4417
987654417,sandeep,55696,33920,21776,4417
987654417,sandeep,52924,36670,16254,4417
987654417,sandeep,56389,14500,41889,4417
987654417,sandeep,62725,22180,40545,4417
987654417,sandeep,42441,28930,13511,4417
987654417,sandeep,72933,39030,33903,4417
987654417,sandeep,68203,18130,50073,4417
987654417,sandeep,75661,42260,33401,4417
987654417,sandeep,80754,40570,40184,4417
987654417,sandeep,87574,24860,62714,4417
987654417,sandeep,43277,28680,14597,4417
987654417,sandeep,72691,22190,50501,4417
987654417,sandeep,71118,18570,52548,4417
987654417,sandeep,63341,17760,45581,4417
987654417,sandeep,59601,38410,21191,4417
987654417,sandeep,68379,55640,12739,4417
987654417,sandeep,37953,19190,18763,4417
987654417,sandeep,70843,67600,3243,4417
987654418,md mustafa,64364,41240,23124,4418
987654418,md mustafa,80853,69970,10883,4418
987654418,md mustafa,77806,36350,41456,4418
987654418,md mustafa,74484,40920,33564,4418
987654418,md mustafa,40802,17070,23732,4418
987654418,md mustafa,61163,19750,41413,4418
987654418,md mustafa,57665,51540,6125,4418
987654418,md mustafa,49074,18100,30974,4418
987654418,md mustafa,64551,63230,1321,4418
987654418,md mustafa,65068,41780,23288,4418
987654418,md mustafa,42199,22540,19659,4418
987654418,md mustafa,75199,47010,28189,4418
987654418,md mustafa,69182,51080,18102,4418
987654418,md mustafa,74319,70940,3379,4418
987654418,md mustafa,78169,49670,28499,4418
987654418,md mustafa,94581,41360,53221,4418
987654418,md mustafa,42672,32600,10072,4418
987654418,md mustafa,67092,42000,25092,4418
987654418,md mustafa,59458,27230,32228,4418
987654418,md mustafa,67059,43620,23439,4418
987654418,md mustafa,93492,61170,32322,4418
987654418,md mustafa,92700,46410,46290,4418
987654418,md mustafa,77399,45950,31449,4418
987654418,md mustafa,73967,56990,16977,4418
987654419,har parsad,96209,59940,36269,4419
987654419,har parsad,36248,18300,17948,4419
987654419,har parsad,54167,45540,8627,4419
987654419,har parsad,67279,48300,18979,4419
987654419,har parsad,55036,14290,40746,4419
987654419,har parsad,56928,30460,26468,4419
987654419,har parsad,65596,28860,36736,4419
987654419,har parsad,42023,28560,13463,4419
987654419,har parsad,74088,23290,50798,4419
987654419,har parsad,96968,27760,69208,4419
987654419,har parsad,87332,44420,42912,4419
987654419,har parsad,97375,55050,42325,4419
987654419,har parsad,100367,33940,66427,4419
987654419,har parsad,40857,34890,5967,4419
987654419,har parsad,66817,46340,20477,4419
987654419,har parsad,61702,21070,40632,4419
987654419,har parsad,58622,15190,43432,4419
987654419,har parsad,59095,15820,43275,4419
987654419,har parsad,74220,48250,25970,4419
987654419,har parsad,37678,34590,3088,4419
987654419,har parsad,71965,28170,43795,4419
987654419,har parsad,95318,27700,67618,4419
987654419,har parsad,93833,54010,39823,4419
987654419,har parsad,108276,105800,2476,4419
987654420,deepak,114964,53760,61204,4420
987654420,deepak,39801,35070,4731,4420
987654420,deepak,55256,39370,15886,4420
987654420,deepak,65596,24180,41416,4420
987654420,deepak,55135,16240,38895,4420
987654420,deepak,60591,49790,10801,4420
987654420,deepak,52836,32390,20446,4420
987654420,deepak,39801,24440,15361,4420
987654420,deepak,74583,41050,33533,4420
987654420,deepak,80402,59150,21252,4420
987654420,deepak,85341,25570,59771,4420
987654420,deepak,92326,71970,20356,4420
987654420,deepak,109387,68700,40687,4420
987654420,deepak,38096,24030,14066,4420
987654420,deepak,60294,37160,23134,4420
987654420,deepak,62813,62420,393,4420
987654420,deepak,57786,18760,39026,4420
987654420,deepak,58083,53230,4853,4420
987654420,deepak,67642,62610,5032,4420
987654420,deepak,36919,13190,23729,4420
987654420,deepak,65024,40680,24344,4420
987654420,deepak,87684,86950,734,4420
987654420,deepak,79764,39400,40364,4420
987654420,deepak,89653,46180,43473,4420
987654421,rahul,120761,52100,68661,4421
987654421,rahul,51692,44540,7152,4421
987654421,rahul,71041,57430,13611,4421
987654421,rahul,73978,51510,22468,4421
987654421,rahul,61383,56470,4913,4421
987654421,rahul,71613,35040,36573,4421
987654421,rahul,35269,35170,99,4421
987654421,rahul,68181,47600,20581,4421
987654421,rahul,81931,77880,4051,4421
987654421,rahul,75936,48530,27406,4421
987654421,rahul,81018,35620,45398,4421
987654421,rahul,98596,60450,38146,4421
987654421,rahul,34818,22630,12188,4421
987654421,rahul,63572,18640,44932,4421
987654421,rahul,66212,19460,46752,4421
987654421,rahul,64001,43160,20841,4421
987654421,rahul,63352,23660,39692,4421
987654421,rahul,40450,36000,4450,4421
987654421,rahul,74803,19910,54893,4421
987654421,rahul,85143,47370,37773,4421
987654421,rahul,82690,42010,40680,4421
987654421,rahul,82701,64260,18441,4421
987654421,rahul,107946,36370,71576,4421
987654421,rahul,54090,35330,18760,4421
987654422,abhishekh,109596,34260,75336,4422
987654422,abhishekh,89818,86590,3228,4422
987654422,abhishekh,92689,44980,47709,4422
987654422,abhishekh,115228,90140,25088,4422
987654422,abhishekh,35423,26930,8493,4422
987654422,abhishekh,56840,29180,27660,4422
987654422,abhishekh,67455,49060,18395,4422
987654422,abhishekh,50735,29770,20965,4422
987654422,abhishekh,57764,44020,13744,4422
987654422,abhishekh,61581,47650,13931,4422
987654422,abhishekh,42254,33110,9144,4422
987654422,abhishekh,66619,46600,20019,4422
987654422,abhishekh,93756,51050,42706,4422
987654422,abhishekh,71459,45630,25829,4422
987654422,abhishekh,92007,88830,3177,4422
987654422,abhishekh,108771,80080,28691,4422
987654422,abhishekh,39086,22700,16386,4422
987654422,abhishekh,58061,42620,15441,4422
987654422,abhishekh,69479,62590,6889,4422
987654422,abhishekh,68093,63570,4523,4422
987654422,abhishekh,74704,30120,44584,4422
987654422,abhishekh,53298,20440,32858,4422
987654422,abhishekh,115932,35370,80562,4422
987654422,abhishekh,97672,86450,11222,4422
987654423,shelender yadav,96352,95610,742,4423
987654423,shelender yadav,104734,38030,66704,4423
987654423,shelender yadav,38602,28560,10042,4423
987654423,shelender yadav,56972,26840,30132,4423
987654423,shelender yadav,60668,59750,918,4423
987654423,shelender yadav,56576,17020,39556,4423
987654423,shelender yadav,61471,26420,35051,4423
987654423,shelender yadav,61823,39690,22133,4423
987654423,shelender yadav,33003,9690,23313,4423
987654423,shelender yadav,64463,24180,40283,4423
987654423,shelender yadav,90643,35300,55343,4423
987654423,shelender yadav,74187,20400,53787,4423
987654423,shelender yadav,84065,25090,58975,4423
987654423,shelender yadav,102809,70640,32169,4423
987654423,shelender yadav,37634,20550,17084,4423
987654423,shelender yadav,51912,43520,8392,4423
987654423,shelender yadav,66476,43770,22706,4423
987654423,shelender yadav,54772,21150,33622,4423
987654423,shelender yadav,60998,40630,20368,4423
987654423,shelender yadav,53331,26510,26821,4423
987654423,shelender yadav,39559,26380,13179,4423
987654423,shelender yadav,68940,54270,14670,4423
987654423,shelender yadav,91182,55220,35962,4423
987654423,shelender yadav,74935,41520,33415,4423
987654424,sanjay,89873,23010,66863,4424
987654424,sanjay,98233,56290,41943,4424
987654424,sanjay,45213,12770,32443,4424
987654424,sanjay,67675,60270,7405,4424
987654424,sanjay,69930,30410,39520,4424
987654424,sanjay,60283,27120,33163,4424
987654424,sanjay,59128,54870,4258,4424
987654424,sanjay,54827,40240,14587,4424
987654424,sanjay,37502,28640,8862,4424
987654424,sanjay,66102,46160,19942,4424
987654424,sanjay,85528,66260,19268,4424
987654424,sanjay,82019,30560,51459,4424
987654424,sanjay,87398,43930,43468,4424
987654424,sanjay,100939,31540,69399,4424
987654424,sanjay,41495,12930,28565,4424
987654424,sanjay,58336,46120,12216,4424
987654424,sanjay,62714,18720,43994,4424
987654424,sanjay,55641,42730,12911,4424
987654424,sanjay,55850,34450,21400,4424
987654424,sanjay,63737,36320,27417,4424
987654424,sanjay,39713,31930,7783,4424
987654424,sanjay,68335,66810,1525,4424
987654424,sanjay,77102,54690,22412,4424
987654424,sanjay,75727,72440,3287,4424
987654425,ankit,89686,60100,29586,4425
987654425,ankit,95549,53790,41759,4425
987654425,ankit,44773,32890,11883,4425
987654425,ankit,70491,53280,17211,4425
987654425,ankit,92513,59690,32823,4425
987654425,ankit,66861,45200,21661,4425
987654425,ankit,85924,84710,1214,4425
987654425,ankit,82602,54240,28362,4425
987654425,ankit,30913,21440,9473,4425
987654425,ankit,49767,34890,14877,4425
987654425,ankit,59997,20400,39597,4425
987654425,ankit,51450,27680,23770,4425
987654425,ankit,61020,56660,4360,4425
987654425,ankit,66993,47480,19513,4425
987654425,ankit,39361,34310,5051,4425
987654425,ankit,72218,46290,25928,4425
987654425,ankit,79742,43850,35892,4425
987654425,ankit,74121,58000,16121,4425
987654425,ankit,71173,59340,11833,4425
987654425,ankit,92755,40800,51955,4425
987654425,ankit,30473,26400,4073,4425
987654425,ankit,50603,37190,13413,4425
987654425,ankit,67059,60390,6669,4425
987654425,ankit,79962,52550,27412,4425
987654426,mohd aakib,79082,49720,29362,4426
987654426,mohd aakib,103370,81170,22200,4426
987654426,mohd aakib,35830,20050,15780,4426
987654426,mohd aakib,55388,54410,978,4426
987654426,mohd aakib,33355,17620,15735,4426
987654426,mohd aakib,71173,42340,28833,4426
987654426,mohd aakib,78026,61600,16426,4426
987654426,mohd aakib,41946,32570,9376,4426
987654426,mohd aakib,41198,15140,26058,4426
987654426,mohd aakib,87662,25960,61702,4426
987654426,mohd aakib,79808,43710,36098,4426
987654426,mohd aakib,47809,19240,28569,4426
987654426,mohd aakib,81271,21990,59281,4426
987654426,mohd aakib,99168,62590,36578,4426
987654426,mohd aakib,91182,83270,7912,4426
987654426,mohd aakib,105130,41560,63570,4426
987654426,mohd aakib,120596,69750,50846,4426
987654426,mohd aakib,49107,41380,7727,4426
987654426,mohd aakib,55168,18590,36578,4426
987654426,mohd aakib,66916,65580,1336,4426
987654426,mohd aakib,62219,57350,4869,4426
987654426,mohd aakib,74341,66850,7491,4426
987654426,mohd aakib,75452,44830,30622,4426
987654426,mohd aakib,60426,40730,19696,4426
987654427,surender singh chauhan,90918,30560,60358,4427
987654427,surender singh chauhan,92667,54150,38517,4427
987654427,surender singh chauhan,82624,32710,49914,4427
987654427,surender singh chauhan,93250,74710,18540,4427
987654427,surender singh chauhan,120244,80350,39894,4427
987654427,surender singh chauhan,55652,51880,3772,4427
987654427,surender singh chauhan,89114,82390,6724,4427
987654427,surender singh chauhan,101082,35460,65622,4427
987654427,surender singh chauhan,88795,64230,24565,4427
987654427,surender singh chauhan,86320,22800,63520,4427
987654427,surender singh chauhan,102809,63240,39569,4427
987654427,surender singh chauhan,39581,14490,25091,4427
987654427,surender singh chauhan,54618,48950,5668,4427
987654427,surender singh chauhan,63429,33040,30389,4427
987654427,surender singh chauhan,59216,36740,22476,4427
987654427,surender singh chauhan,64254,39220,25034,4427
987654427,surender singh chauhan,70656,27550,43106,4427
987654427,surender singh chauhan,39493,22180,17313,4427
987654427,surender singh chauhan,63319,41190,22129,4427
987654427,surender singh chauhan,86364,64230,22134,4427
987654427,surender singh chauhan,78686,71360,7326,4427
987654427,surender singh chauhan,85682,57260,28422,4427
987654427,surender singh chauhan,93624,36470,57154,4427
987654427,surender singh chauhan,36094,24260,11834,4427
987654428,amit,77839,41080,36759,4428
987654428,amit,81238,66910,14328,4428
987654428,amit,72713,18240,54473,4428
987654428,amit,85935,67020,18915,4428
987654428,amit,108364,63620,44744,4428
987654428,amit,43013,29960,13053,4428
987654428,amit,68533,38040,30493,4428
987654428,amit,73527,46310,27217,4428
987654428,amit,55542,21680,33862,4428
987654428,amit,60327,19420,40907,4428
987654428,amit,55817,50880,4937,4428
987654428,amit,34488,24120,10368,4428
987654428,amit,69710,67860,1850,4428
987654428,amit,76376,47460,28916,4428
987654428,amit,64639,41780,22859,4428
987654428,amit,66971,43730,23241,4428
987654428,amit,94251,52080,42171,4428
987654428,amit,36985,18900,18085,4428
987654428,amit,47578,42080,5498,4428
987654428,amit,60756,27390,33366,4428
987654428,amit,48524,23430,25094,4428
987654428,amit,52374,40410,11964,4428
987654428,amit,55663,16330,39333,4428
987654428,amit,40648,10530,30118,4428
987654429,arjun,70414,67470,2944,4429
987654429,arjun,83526,79850,3676,4429
987654429,arjun,74693,62860,11833,4429
987654429,arjun,70865,55660,15205,4429
987654429,arjun,112258,101010,11248,4429
987654429,arjun,46368,12020,34348,4429
987654429,arjun,90654,89830,824,4429
987654429,arjun,75166,67260,7906,4429
987654429,arjun,99751,58400,41351,4429
987654429,arjun,95010,54830,40180,4429
987654429,arjun,37260,15960,21300,4429
987654429,arjun,57126,23880,33246,4429
987654429,arjun,57643,51160,6483,4429
987654429,arjun,55311,22510,32801,4429
987654429,arjun,56565,50370,6195,4429
987654429,arjun,52187,24740,27447,4429
987654429,arjun,28966,16690,12276,4429
987654429,arjun,62615,39510,23105,4429
987654429,arjun,72152,50890,21262,4429
987654429,arjun,66498,23800,42698,4429
987654429,arjun,77586,27900,49686,4429
987654429,arjun,93723,26790,66933,4429
987654429,arjun,36028,32080,3948,4429
987654429,arjun,53529,23310,30219,4429
987654430,rahul sharma,59139,42810,16329,4430
987654430,rahul sharma,45367,19170,26197,4430
987654430,rahul sharma,44520,36450,8070,4430
987654430,rahul sharma,53364,19280,34084,4430
987654430,rahul sharma,31133,13370,17763,4430
987654430,rahul sharma,64298,18030,46268,4430
987654430,rahul sharma,73659,19030,54629,4430
987654430,rahul sharma,70788,30800,39988,4430
987654430,rahul sharma,75947,55420,20527,4430
987654430,rahul sharma,103117,37100,66017,4430
987654430,rahul sharma,41902,13070,28832,4430
987654430,rahul sharma,59183,26460,32723,4430
987654430,rahul sharma,59194,40070,19124,4430
987654430,rahul sharma,50273,21370,28903,4430
987654430,rahul sharma,44377,42670,1707,4430
987654430,rahul sharma,53914,31190,22724,4430
987654430,rahul sharma,32090,19810,12280,4430
987654430,rahul sharma,55509,40320,15189,4430
987654430,rahul sharma,72614,36850,35764,4430
987654430,rahul sharma,65882,36360,29522,4430
987654430,rahul sharma,75870,19230,56640,4430
987654430,rahul sharma,81964,51460,30504,4430
987654430,rahul sharma,24874,14950,9924,4430
987654430,rahul sharma,45125,22220,22905,4430
987654431,keshar ansari,50548,22060,28488,4431
987654431,keshar ansari,46038,30860,15178,4431
987654431,keshar ansari,47941,32500,15441,4431
987654431,keshar ansari,53045,33310,19735,4431
987654431,keshar ansari,27393,17990,9403,4431
987654431,keshar ansari,57137,42490,14647,4431
987654431,keshar ansari,68720,53490,15230,4431
987654431,keshar ansari,66850,57210,9640,4431
987654431,keshar ansari,77674,65350,12324,4431
987654431,keshar ansari,88806,35590,53216,4431
987654431,keshar ansari,34180,17190,16990,4431
987654431,keshar ansari,67345,57450,9895,4431
987654431,keshar ansari,80787,31420,49367,4431
987654431,keshar ansari,68489,36200,32289,4431
987654431,keshar ansari,73780,50980,22800,4431
987654431,keshar ansari,85594,22060,63534,4431
987654431,keshar ansari,29296,21140,8156,4431
987654431,keshar ansari,43629,33710,9919,4431
987654431,keshar ansari,48007,15500,32507,4431
987654431,keshar ansari,39207,30840,8367,4431
987654431,keshar ansari,42804,14930,27874,4431
987654431,keshar ansari,57060,26800,30260,4431
987654431,keshar ansari,26975,17950,9025,4431
987654431,keshar ansari,55157,41340,13817,4431
987654432,raju ,78697,70630,8067,4432
987654432,raju ,69567,46880,22687,4432
987654432,raju ,78015,73330,4685,4432
987654432,raju ,83746,31210,52536,4432
987654432,raju ,32739,13930,18809,4432
987654432,raju ,49393,43010,6383,4432
987654432,raju ,60778,47160,13618,4432
987654432,raju ,47017,29420,17597,4432
987654432,raju ,47721,46170,1551,4432
987654432,raju ,60426,40160,20266,4432
987654432,raju ,28295,13970,14325,4432
987654432,raju ,56103,17010,39093,4432
987654432,raju ,76838,76570,268,4432
987654432,raju ,71305,39530,31775,4432
987654432,raju ,88663,79780,8883,4432
987654432,raju ,107605,57870,49735,4432
987654432,raju ,30990,19260,11730,4432
987654432,raju ,47754,16620,31134,4432
987654432,raju ,52649,44060,8589,4432
987654432,raju ,44718,14590,30128,4432
987654432,raju ,53188,34990,18198,4432
987654432,raju ,52825,22080,30745,4432
987654432,raju ,30429,23730,6699,4432
987654432,raju ,57676,33330,24346,4432
987654433,kuldeep singh,73098,41420,31678,4433
987654433,kuldeep singh,65464,58300,7164,4433
987654433,kuldeep singh,73120,47360,25760,4433
987654433,kuldeep singh,87519,22420,65099,4433
987654433,kuldeep singh,28416,23990,4426,4433
987654433,kuldeep singh,48667,40100,8567,4433
987654433,kuldeep singh,62461,54930,7531,4433
987654433,kuldeep singh,52737,31570,21167,4433
987654433,kuldeep singh,64881,49020,15861,4433
987654433,kuldeep singh,31738,10580,21158,4433
987654433,kuldeep singh,63759,28270,35489,4433
987654433,kuldeep singh,71316,37800,33516,4433
987654433,kuldeep singh,77652,63350,14302,4433
987654433,kuldeep singh,79841,37670,42171,4433
987654433,kuldeep singh,96869,37590,59279,4433
987654433,kuldeep singh,32970,14540,18430,4433
987654433,kuldeep singh,62967,19460,43507,4433
987654433,kuldeep singh,56587,21730,34857,4433
987654433,kuldeep singh,56994,46490,10504,4433
987654433,kuldeep singh,53661,14220,39441,4433
987654433,kuldeep singh,29307,13500,15807,4433
987654433,kuldeep singh,53837,23200,30637,4433
987654433,kuldeep singh,73483,55570,17913,4433
987654433,kuldeep singh,55784,19590,36194,4433
987654434,santlal,68181,17460,50721,4434
987654434,santlal,88036,37010,51026,4434
987654434,santlal,28867,22060,6807,4434
987654434,santlal,43431,13510,29921,4434
987654434,santlal,52968,31150,21818,4434
987654434,santlal,57313,22520,34793,4434
987654434,santlal,50779,44490,6289,4434
987654434,santlal,50933,29860,21073,4434
987654434,santlal,29923,25780,4143,4434
987654434,santlal,65255,56090,9165,4434
987654434,santlal,65728,48340,17388,4434
987654434,santlal,59007,54410,4597,4434
987654434,santlal,78125,58730,19395,4434
987654434,santlal,98717,86330,12387,4434
987654434,santlal,32057,24370,7687,4434
987654434,santlal,74605,39170,35435,4434
987654434,santlal,83559,24140,59419,4434
987654434,santlal,77058,54450,22608,4434
987654434,santlal,86320,75310,11010,4434
987654434,santlal,25358,21320,4038,4434
987654434,santlal,37084,34360,2724,4434
987654434,santlal,53848,34750,19098,4434
987654434,santlal,46599,34480,12119,4434
987654434,santlal,53573,33230,20343,4434
987654435,lalit rana,34664,9260,25404,4435
987654435,lalit rana,84362,84180,182,4435
987654435,lalit rana,76321,52120,24201,4435
987654435,lalit rana,98442,95140,3302,4435
987654435,lalit rana,90159,87060,3099,4435
987654435,lalit rana,31243,26940,4303,4435
987654435,lalit rana,46214,45270,944,4435
987654435,lalit rana,59271,55450,3821,4435
987654435,lalit rana,48546,27390,21156,4435
987654435,lalit rana,49646,20870,28776,4435
987654435,lalit rana,53056,36970,16086,4435
987654435,lalit rana,29527,15990,13537,4435
987654435,lalit rana,54838,44120,10718,4435
987654435,lalit rana,73747,46460,27287,4435
987654435,lalit rana,71052,68780,2272,4435
987654435,lalit rana,92546,62190,30356,4435
987654435,lalit rana,98354,79150,19204,4435
987654435,lalit rana,31606,30900,706,4435
987654435,lalit rana,49602,22050,27552,4435
987654435,lalit rana,56081,32570,23511,4435
987654435,lalit rana,45972,23880,22092,4435
987654435,lalit rana,49470,41950,7520,4435
987654435,lalit rana,50130,35100,15030,4435
987654435,lalit rana,29791,21120,8671,4435
987654436,pulkit sharma,47468,38120,9348,4436
987654436,pulkit sharma,61856,33840,28016,4436
987654436,pulkit sharma,60767,44860,15907,4436
987654436,pulkit sharma,73648,47800,25848,4436
987654436,pulkit sharma,84318,30440,53878,4436
987654436,pulkit sharma,27789,12840,14949,4436
987654436,pulkit sharma,43299,35600,7699,4436
987654436,pulkit sharma,54211,51730,2481,4436
987654436,pulkit sharma,46181,24550,21631,4436
987654436,pulkit sharma,48326,33760,14566,4436
987654436,pulkit sharma,47501,20040,27461,4436
987654436,pulkit sharma,30946,26190,4756,4436
987654436,pulkit sharma,62054,47900,14154,4436
987654436,pulkit sharma,73967,61850,12117,4436
987654436,pulkit sharma,69699,47760,21939,4436
987654436,pulkit sharma,82789,62020,20769,4436
987654436,pulkit sharma,103315,95250,8065,4436
987654436,pulkit sharma,39207,36740,2467,4436
987654436,pulkit sharma,48513,38350,10163,4436
987654436,pulkit sharma,56422,49380,7042,4436
987654436,pulkit sharma,40989,39350,1639,4436
987654436,pulkit sharma,42221,33910,8311,4436
987654436,pulkit sharma,49008,32530,16478,4436
987654436,pulkit sharma,31298,9580,21718,4436
987654437,aman soni,55784,14320,41464,4437
987654437,aman soni,72460,63300,9160,4437
987654437,aman soni,58369,55330,3039,4437
987654437,aman soni,77168,35460,41708,4437
987654437,aman soni,96330,73740,22590,4437
987654437,aman soni,30341,15350,14991,4437
987654437,aman soni,48733,38290,10443,4437
987654437,aman soni,61185,29450,31735,4437
987654437,aman soni,44916,42800,2116,4437
987654437,aman soni,49734,46450,3284,4437
987654437,aman soni,52627,25940,26687,4437
987654437,aman soni,30924,12980,17944,4437
987654437,aman soni,56675,25110,31565,4437
987654437,aman soni,73219,55000,18219,4437
987654437,aman soni,72625,32360,40265,4437
987654437,aman soni,82503,71090,11413,4437
987654437,aman soni,97584,24550,73034,4437
987654437,aman soni,31375,24830,6545,4437
987654437,aman soni,48260,45700,2560,4437
987654437,aman soni,61130,54980,6150,4437
987654437,aman soni,43827,20240,23587,4437
987654437,aman soni,45587,42060,3527,4437
987654437,aman soni,48040,19380,28660,4437
987654437,aman soni,26744,9940,16804,4437
987654438,jahoor ahmed meer,54992,16800,38192,4438
987654438,jahoor ahmed meer,73406,29390,44016,4438
987654438,jahoor ahmed meer,63066,60230,2836,4438
987654438,jahoor ahmed meer,70370,61800,8570,4438
987654438,jahoor ahmed meer,91303,54050,37253,4438
987654438,jahoor ahmed meer,23059,9700,13359,4438
987654438,jahoor ahmed meer,43904,33610,10294,4438
987654438,jahoor ahmed meer,47952,27290,20662,4438
987654438,jahoor ahmed meer,39614,29580,10034,4438
987654438,jahoor ahmed meer,43299,25090,18209,4438
987654438,jahoor ahmed meer,45499,11990,33509,4438
987654438,jahoor ahmed meer,28273,17650,10623,4438
987654438,jahoor ahmed meer,60371,19820,40551,4438
987654438,jahoor ahmed meer,66201,58430,7771,4438
987654438,jahoor ahmed meer,62527,24440,38087,4438
987654438,jahoor ahmed meer,71228,69840,1388,4438
987654438,jahoor ahmed meer,94801,30300,64501,4438
987654438,jahoor ahmed meer,26128,16180,9948,4438
987654438,jahoor ahmed meer,45125,28820,16305,4438
987654438,jahoor ahmed meer,57027,24040,32987,4438
987654438,jahoor ahmed meer,29714,12800,16914,4438
987654438,jahoor ahmed meer,63165,59500,3665,4438
987654438,jahoor ahmed meer,27371,11780,15591,4438
987654438,jahoor ahmed meer,52627,32650,19977,4438
987654439,sumit,36501,10700,25801,4439
987654439,sumit,96363,57890,38473,4439
987654439,sumit,47457,42350,5107,4439
987654439,sumit,88190,39370,48820,4439
987654439,sumit,86617,37000,49617,4439
987654439,sumit,94405,29980,64425,4439
987654439,sumit,103205,66030,37175,4439
987654439,sumit,113622,54670,58952,4439
987654439,sumit,36886,19040,17846,4439
987654439,sumit,54805,33570,21235,4439
987654439,sumit,63704,44670,19034,4439
987654439,sumit,54112,25530,28582,4439
987654439,sumit,59348,30910,28438,4439
987654439,sumit,56169,48740,7429,4439
987654439,sumit,42771,36130,6641,4439
987654439,sumit,60591,54270,6321,4439
987654439,sumit,80765,78480,2285,4439
987654439,sumit,75804,45900,29904,4439
987654439,sumit,90885,72790,18095,4439
987654439,sumit,105130,104830,300,4439
987654439,sumit,44839,17240,27599,4439
987654439,sumit,55432,13870,41562,4439
987654439,sumit,63847,39170,24677,4439
987654439,sumit,49943,37360,12583,4439
987654440,tammanne,51934,51870,64,4440
987654440,tammanne,55388,32820,22568,4440
987654440,tammanne,33927,25200,8727,4440
987654440,tammanne,54255,17450,36805,4440
987654440,tammanne,69831,24500,45331,4440
987654440,tammanne,68225,27070,41155,4440
987654440,tammanne,74649,57680,16969,4440
987654440,tammanne,86221,81280,4941,4440
987654440,tammanne,27833,24670,3163,4440
987654440,tammanne,47589,30700,16889,4440
987654440,tammanne,55586,22960,32626,4440
987654440,tammanne,46808,45400,1408,4440
987654440,tammanne,47116,15530,31586,4440
987654440,tammanne,49657,26620,23037,4440
987654440,tammanne,27294,26500,794,4440
987654440,tammanne,61097,19310,41787,4440
987654440,tammanne,73615,48270,25345,4440
987654440,tammanne,64056,38370,25686,4440
987654440,tammanne,83999,45320,38679,4440
987654440,tammanne,78796,35490,43306,4440
987654440,tammanne,32387,17820,14567,4440
987654440,tammanne,52044,43280,8764,4440
987654440,tammanne,66025,35600,30425,4440
987654440,tammanne,51725,15340,36385,4440
987654441,kailash kumar,47204,42510,4694,4441
987654441,kailash kumar,42903,29300,13603,4441
987654441,kailash kumar,25204,24690,514,4441
987654441,kailash kumar,54750,20410,34340,4441
987654441,kailash kumar,67103,46100,21003,4441
987654441,kailash kumar,58919,28310,30609,4441
987654441,kailash kumar,74638,33080,41558,4441
987654441,kailash kumar,85033,38420,46613,4441
987654441,kailash kumar,30242,12500,17742,4441
987654441,kailash kumar,42100,27480,14620,4441
987654441,kailash kumar,43145,42740,405,4441
987654441,kailash kumar,38701,12900,25801,4441
987654441,kailash kumar,42441,24700,17741,4441
987654441,kailash kumar,56807,31900,24907,4441
987654441,kailash kumar,23763,20370,3393,4441
987654441,kailash kumar,55278,32000,23278,4441
987654441,kailash kumar,66080,18500,47580,4441
987654441,kailash kumar,57478,56660,818,4441
987654441,kailash kumar,72911,29300,43611,4441
987654441,kailash kumar,90467,77750,12717,4441
987654441,kailash kumar,31562,20800,10762,4441
987654441,kailash kumar,52902,31700,21202,4441
987654441,kailash kumar,52561,48840,3721,4441
987654441,kailash kumar,53507,43920,9587,4441
987654442,bhagwati prasad,59436,50130,9306,4442
987654442,bhagwati prasad,28724,28210,514,4442
987654442,bhagwati prasad,54959,49070,5889,4442
987654442,bhagwati prasad,71305,34870,36435,4442
987654442,bhagwati prasad,57280,40690,16590,4442
987654442,bhagwati prasad,70821,48530,22291,4442
987654442,bhagwati prasad,82954,21370,61584,4442
987654442,bhagwati prasad,22333,15970,6363,4442
987654442,bhagwati prasad,39988,28700,11288,4442
987654442,bhagwati prasad,47138,31800,15338,4442
987654442,bhagwati prasad,39075,30740,8335,4442
987654442,bhagwati prasad,49283,17080,32203,4442
987654442,bhagwati prasad,44091,30110,13981,4442
987654442,bhagwati prasad,26282,20870,5412,4442
987654442,bhagwati prasad,57566,23670,33896,4442
987654442,bhagwati prasad,72834,55770,17064,4442
987654442,bhagwati prasad,64573,43660,20913,4442
987654442,bhagwati prasad,77157,33770,43387,4442
987654442,bhagwati prasad,82217,57430,24787,4442
987654442,bhagwati prasad,25633,17190,8443,4442
987654442,bhagwati prasad,39526,28020,11506,4442
987654442,bhagwati prasad,54057,16150,37907,4442
987654442,bhagwati prasad,48029,35240,12789,4442
987654442,bhagwati prasad,51758,36600,15158,4442
987654443,ajay,43321,33910,9411,4443
987654443,ajay,32442,8910,23532,4443
987654443,ajay,70370,57930,12440,4443
987654443,ajay,75364,52530,22834,4443
987654443,ajay,66432,42450,23982,4443
987654443,ajay,76926,67070,9856,4443
987654443,ajay,88311,77940,10371,4443
987654443,ajay,20870,10280,10590,4443
987654443,ajay,45224,19840,25384,4443
987654443,ajay,47072,41850,5222,4443
987654443,ajay,41220,26740,14480,4443
987654443,ajay,45213,29620,15593,4443
987654443,ajay,44608,43380,1228,4443
987654443,ajay,19055,9550,9505,4443
987654443,ajay,51241,46590,4651,4443
987654443,ajay,76222,47630,28592,4443
987654443,ajay,66520,65150,1370,4443
987654443,ajay,77443,54220,23223,4443
987654443,ajay,91787,33980,57807,4443
987654443,ajay,26238,21290,4948,4443
987654443,ajay,42991,41760,1231,4443
987654443,ajay,51208,47400,3808,4443
987654443,ajay,45818,20890,24928,4443
987654443,ajay,45070,30290,14780,4443
987654444,silender,52935,23750,29185,4444
987654444,silender,26172,21700,4472,4444
987654444,silender,54035,31310,22725,4444
987654444,silender,80226,32430,47796,4444
987654444,silender,79247,28590,50657,4444
987654444,silender,75782,39640,36142,4444
987654444,silender,91116,68190,22926,4444
987654444,silender,24907,15140,9767,4444
987654444,silender,33201,24620,8581,4444
987654444,silender,43926,43720,206,4444
987654444,silender,40659,39380,1279,4444
987654444,silender,38162,25960,12202,4444
987654444,silender,43959,15920,28039,4444
987654444,silender,21519,7960,13559,4444
987654444,silender,57214,48540,8674,4444
987654444,silender,65288,36220,29068,4444
987654444,silender,58017,14540,43477,4444
987654444,silender,76068,35080,40988,4444
987654444,silender,85341,69960,15381,4444
987654444,silender,25765,22410,3355,4444
987654444,silender,42771,30800,11971,4444
987654444,silender,48469,38640,9829,4444
987654444,silender,40428,28950,11478,4444
987654444,silender,49723,17680,32043,4444
987654445,deepak,43640,29870,13770,4445
987654445,deepak,28812,7620,21192,4445
987654445,deepak,54629,26820,27809,4445
987654445,deepak,70128,20130,49998,4445
987654445,deepak,55971,33410,22561,4445
987654445,deepak,72218,49580,22638,4445
987654445,deepak,85561,49280,36281,4445
987654445,deepak,27228,10300,16928,4445
987654445,deepak,47303,36870,10433,4445
987654445,deepak,54651,25810,28841,4445
987654445,deepak,41814,21080,20734,4445
987654445,deepak,45070,39480,5590,4445
987654445,deepak,50372,32770,17602,4445
987654445,deepak,25666,14900,10766,4445
987654445,deepak,65926,42470,23456,4445
987654445,deepak,73175,39400,33775,4445
987654445,deepak,58985,49080,9905,4445
987654445,deepak,78521,55310,23211,4445
987654445,deepak,90808,59870,30938,4445
987654445,deepak,29263,16730,12533,4445
987654445,deepak,42188,33870,8318,4445
987654445,deepak,50768,19170,31598,4445
987654445,deepak,47325,43510,3815,4445
987654445,deepak,53705,48520,5185,4445
987654446,akhilesh,54442,40420,14022,4446
987654446,akhilesh,30781,26780,4001,4446
987654446,akhilesh,58083,18000,40083,4446
987654446,akhilesh,69512,49440,20072,4446
987654446,akhilesh,61119,52610,8509,4446
987654446,akhilesh,77729,44780,32949,4446
987654446,akhilesh,83262,80760,2502,4446
987654446,akhilesh,29538,23350,6188,4446
987654446,akhilesh,62791,61740,1051,4446
987654446,akhilesh,77927,47710,30217,4446
987654446,akhilesh,68764,64740,4024,4446
987654446,akhilesh,73362,62530,10832,4446
987654446,akhilesh,91523,54100,37423,4446
987654446,akhilesh,22784,19770,3014,4446
987654446,akhilesh,43464,24840,18624,4446
987654446,akhilesh,52066,42870,9196,4446
987654446,akhilesh,44762,43990,772,4446
987654446,akhilesh,51505,47650,3855,4446
987654446,akhilesh,28119,13600,14519,4446
987654446,akhilesh,59623,18760,40863,4446
987654446,akhilesh,75903,32220,43683,4446
987654446,akhilesh,64507,29250,35257,4446
987654446,akhilesh,82921,62500,20421,4446
987654446,akhilesh,81689,65390,16299,4446
987654447,dipendra kumar,28152,9870,18282,4447
987654447,dipendra kumar,54794,17880,36914,4447
987654447,dipendra kumar,52847,15950,36897,4447
987654447,dipendra kumar,47061,26780,20281,4447
987654447,dipendra kumar,56070,40400,15670,4447
987654447,dipendra kumar,27767,26500,1267,4447
987654447,dipendra kumar,63770,48640,15130,4447
987654447,dipendra kumar,85495,80680,4815,4447
987654447,dipendra kumar,97672,68400,29272,4447
987654447,dipendra kumar,88135,62250,25885,4447
987654447,dipendra kumar,27261,24320,2941,4447
987654447,dipendra kumar,51373,28930,22443,4447
987654447,dipendra kumar,69545,27900,41645,4447
987654447,dipendra kumar,55751,25910,29841,4447
987654447,dipendra kumar,68225,60290,7935,4447
987654447,dipendra kumar,81876,45260,36616,4447
987654447,dipendra kumar,28262,15490,12772,4447
987654447,dipendra kumar,41209,39110,2099,4447
987654447,dipendra kumar,55509,35190,20319,4447
987654447,dipendra kumar,42155,31340,10815,4447
987654447,dipendra kumar,47886,37470,10416,4447
987654447,dipendra kumar,42287,21270,21017,4447
987654447,dipendra kumar,24302,16620,7682,4447
987654447,dipendra kumar,59249,54590,4659,4447
987654448,nitin,66179,54850,11329,4448
987654448,nitin,57709,17960,39749,4448
987654448,nitin,75705,73420,2285,4448
987654448,nitin,88124,42040,46084,4448
987654448,nitin,29186,16910,12276,4448
987654448,nitin,45180,29180,16000,4448
987654448,nitin,51219,45530,5689,4448
987654448,nitin,48018,25630,22388,4448
987654448,nitin,59579,40470,19109,4448
987654448,nitin,38580,25850,12730,4448
987654448,nitin,98706,65080,33626,4448
987654448,nitin,71382,29350,42032,4448
987654448,nitin,77850,56940,20910,4448
987654448,nitin,85044,81000,4044,4448
987654448,nitin,25204,18920,6284,4448
987654448,nitin,52638,35440,17198,4448
987654448,nitin,74968,39000,35968,4448
987654448,nitin,77421,39480,37941,4448
987654448,nitin,72537,70810,1727,4448
987654448,nitin,81678,58090,23588,4448
987654448,nitin,27712,20450,7262,4448
987654448,nitin,48744,46090,2654,4448
987654448,nitin,53738,51060,2678,4448
987654448,nitin,43783,43460,323,4448
987654449,doodhnath pandit,41099,38280,2819,4449
987654449,doodhnath pandit,40131,33720,6411,4449
987654449,doodhnath pandit,24973,6660,18313,4449
987654449,doodhnath pandit,57533,15820,41713,4449
987654449,doodhnath pandit,75705,35820,39885,4449
987654449,doodhnath pandit,65827,42120,23707,4449
987654449,doodhnath pandit,87497,61660,25837,4449
987654449,doodhnath pandit,91149,70460,20689,4449
987654449,doodhnath pandit,28394,19270,9124,4449
987654449,doodhnath pandit,49195,28470,20725,4449
987654449,doodhnath pandit,61075,16840,44235,4449
987654449,doodhnath pandit,45752,39760,5992,4449
987654449,doodhnath pandit,44421,34660,9761,4449
987654449,doodhnath pandit,46731,13510,33221,4449
987654449,doodhnath pandit,23422,8650,14772,4449
987654449,doodhnath pandit,60503,38950,21553,4449
987654449,doodhnath pandit,72262,57500,14762,4449
987654449,doodhnath pandit,69644,40060,29584,4449
987654449,doodhnath pandit,69941,41690,28251,4449
987654449,doodhnath pandit,90104,60150,29954,4449
987654449,doodhnath pandit,27448,25680,1768,4449
987654449,doodhnath pandit,41187,35370,5817,4449
987654449,doodhnath pandit,58556,24810,33746,4449
987654449,doodhnath pandit,44003,32580,11423,4449
987654450,aslam allam,38613,25400,13213,4450
987654450,aslam allam,46445,33570,12875,4450
987654450,aslam allam,27437,7520,19917,4450
987654450,aslam allam,66465,43680,22785,4450
987654450,aslam allam,75243,57110,18133,4450
987654450,aslam allam,68687,19190,49497,4450
987654450,aslam allam,75991,69990,6001,4450
987654450,aslam allam,91083,77600,13483,4450
987654450,aslam allam,26469,13930,12539,4450
987654450,aslam allam,48546,35170,13376,4450
987654450,aslam allam,62560,23140,39420,4450
987654450,aslam allam,40098,30160,9938,4450
987654450,aslam allam,42386,36520,5866,4450
987654450,aslam allam,38129,12920,25209,4450
987654450,aslam allam,26106,11650,14456,4450
987654450,aslam allam,57841,32310,25531,4450
987654450,aslam allam,67334,58030,9304,4450
987654450,aslam allam,71239,24020,47219,4450
987654450,aslam allam,64903,61540,3363,4450
987654450,aslam allam,83559,46900,36659,4450
987654450,aslam allam,26007,10810,15197,4450
987654450,aslam allam,39889,31000,8889,4450
987654450,aslam allam,53243,50260,2983,4450
987654450,aslam allam,38668,32260,6408,4450
987654451,rahul,48018,16390,31628,4451
987654451,rahul,45488,12920,32568,4451
987654451,rahul,29340,28100,1240,4451
987654451,rahul,55047,19420,35627,4451
987654451,rahul,67004,23660,43344,4451
987654451,rahul,55498,18640,36858,4451
987654451,rahul,69743,20960,48783,4451
987654451,rahul,81656,38050,43606,4451
987654451,rahul,25787,13450,12337,4451
987654451,rahul,44729,38940,5789,4451
987654451,rahul,53342,52420,922,4451
987654451,rahul,59689,42640,17049,4451
987654451,rahul,79115,68620,10495,4451
987654451,rahul,68126,55540,12586,4451
987654451,rahul,60844,25490,35354,4451
987654451,rahul,67620,25100,42520,4451
987654451,rahul,79412,77270,2142,4451
987654451,rahul,51923,15080,36843,4451
987654451,rahul,67752,63960,3792,4451
987654451,rahul,70491,65130,5361,4451
987654451,rahul,61251,38870,22381,4451
987654451,rahul,71349,47530,23819,4451
987654451,rahul,67301,33350,33951,4451
987654451,rahul,63451,55680,7771,4451
987654452,jitender kumar,58996,36030,22966,4452
987654452,jitender kumar,69105,37500,31605,4452
987654452,jitender kumar,70733,29990,40743,4452
987654452,jitender kumar,82481,57780,24701,4452
987654452,jitender kumar,74407,50380,24027,4452
987654452,jitender kumar,51076,23760,27316,4452
987654452,jitender kumar,63297,35710,27587,4452
987654452,jitender kumar,53661,33040,20621,4452
987654452,jitender kumar,53595,24930,28665,4452
987654452,jitender kumar,60316,17980,42336,4452
987654452,jitender kumar,67653,62140,5513,4452
987654452,jitender kumar,56400,40590,15810,4452
987654452,jitender kumar,65145,44480,20665,4452
987654452,jitender kumar,69567,68890,677,4452
987654452,jitender kumar,86936,41860,45076,4452
987654452,jitender kumar,94295,84310,9985,4452
987654452,jitender kumar,88707,25640,63067,4452
987654452,jitender kumar,50625,35430,15195,4452
987654452,jitender kumar,52561,22360,30201,4452
987654452,jitender kumar,55278,49710,5568,4452
987654452,jitender kumar,53936,32730,21206,4452
987654452,jitender kumar,57764,54930,2834,4452
987654452,jitender kumar,46984,36000,10984,4452
987654452,jitender kumar,52176,35320,16856,4452
987654453,adnan,68181,47890,20291,4453
987654453,adnan,64199,27140,37059,4453
987654453,adnan,69798,52110,17688,4453
987654453,adnan,73571,27610,45961,4453
987654453,adnan,87002,25020,61982,4453
987654453,adnan,64892,37110,27782,4453
987654453,adnan,59315,56080,3235,4453
987654453,adnan,55795,43490,12305,4453
987654453,adnan,64463,59610,4853,4453
987654453,adnan,58369,36550,21819,4453
987654453,adnan,70788,46000,24788,4453
987654453,adnan,56037,38110,17927,4453
987654453,adnan,64188,16270,47918,4453
987654453,adnan,71426,48990,22436,4453
987654453,adnan,73208,57680,15528,4453
987654453,adnan,83372,29080,54292,4453
987654453,adnan,86386,34020,52366,4453
987654453,adnan,59689,40690,18999,4453
987654453,adnan,66883,59180,7703,4453
987654453,adnan,55850,19200,36650,4453
987654453,adnan,66586,37830,28756,4453
987654453,adnan,71646,34810,36836,4453
987654453,adnan,55960,33160,22800,4453
987654453,adnan,69809,63240,6569,4453
987654454,vijay,66498,63480,3018,4454
987654454,vijay,64903,18730,46173,4454
987654454,vijay,71734,66790,4944,4454
987654454,vijay,84494,29300,55194,4454
987654454,vijay,53749,49050,4699,4454
987654454,vijay,75639,30840,44799,4454
987654454,vijay,65398,60380,5018,4454
987654454,vijay,62637,22350,40287,4454
987654454,vijay,53397,33020,20377,4454
987654454,vijay,59997,29960,30037,4454
987654454,vijay,73230,22700,50530,4454
987654454,vijay,66201,50410,15791,4454
987654454,vijay,72977,27670,45307,4454
987654454,vijay,65728,55260,10468,4454
987654454,vijay,89675,80030,9645,4454
987654454,vijay,68093,59260,8833,4454
987654454,vijay,89312,79840,9472,4454
987654454,vijay,75397,31940,43457,4454
987654454,vijay,69622,59610,10012,4454
987654454,vijay,83218,67560,15658,4454
987654454,vijay,51021,15210,35811,4454
987654454,vijay,57082,54160,2922,4454
987654454,vijay,61416,39590,21826,4454
987654454,vijay,53166,46610,6556,4454
987654455,yogesh,59953,21980,37973,4455
987654455,yogesh,56510,46410,10100,4455
987654455,yogesh,63957,54540,9417,4455
987654455,yogesh,71811,55480,16331,4455
987654455,yogesh,65145,22040,43105,4455
987654455,yogesh,65508,60740,4768,4455
987654455,yogesh,77102,69360,7742,4455
987654455,yogesh,92942,89900,3042,4455
987654455,yogesh,50526,13030,37496,4455
987654455,yogesh,52792,14570,38222,4455
987654455,yogesh,52033,24860,27173,4455
987654455,yogesh,54761,47420,7341,4455
987654455,yogesh,63517,48760,14757,4455
987654455,yogesh,68753,38630,30123,4455
987654455,yogesh,74055,30420,43635,4455
987654455,yogesh,72042,21520,50522,4455
987654455,yogesh,64408,58320,6088,4455
987654455,yogesh,74594,23510,51084,4455
987654455,yogesh,58732,31890,26842,4455
987654455,yogesh,56334,52900,3434,4455
987654455,yogesh,52638,17860,34778,4455
987654455,yogesh,38646,20810,17836,4455
987654455,yogesh,55729,18570,37159,4455
987654455,yogesh,63770,37550,26220,4455
987654456,kabir,49668,27710,21958,4456
987654456,kabir,75276,67730,7546,4456
987654456,kabir,54079,16060,38019,4456
987654456,kabir,71008,36820,34188,4456
987654456,kabir,76541,31700,44841,4456
987654456,kabir,91358,76940,14418,4456
987654456,kabir,57137,56770,367,4456
987654456,kabir,63385,50100,13285,4456
987654456,kabir,50625,47880,2745,4456
987654456,kabir,55553,35610,19943,4456
987654456,kabir,60701,43070,17631,4456
987654456,kabir,64111,19830,44281,4456
987654456,kabir,51890,25370,26520,4456
987654456,kabir,70194,54300,15894,4456
987654456,kabir,64133,41790,22343,4456
987654456,kabir,65629,57640,7989,4456
987654456,kabir,69523,54820,14703,4456
987654456,kabir,83680,35600,48080,4456
987654456,kabir,56477,37900,18577,4456
987654456,kabir,61262,39020,22242,4456
987654456,kabir,52792,48620,4172,4456
987654456,kabir,47897,28260,19637,4456
987654456,kabir,53342,33840,19502,4456
987654456,kabir,58908,49800,9108,4456
987654457,sarvesh,58402,26780,31622,4457
987654457,sarvesh,63253,19830,43423,4457
987654457,sarvesh,64518,28770,35748,4457
987654457,sarvesh,71602,25440,46162,4457
987654457,sarvesh,72845,20700,52145,4457
987654457,sarvesh,85198,27840,57358,4457
987654457,sarvesh,50790,50140,650,4457
987654457,sarvesh,58215,17910,40305,4457
987654457,sarvesh,50702,40500,10202,4457
987654457,sarvesh,60910,37890,23020,4457
987654457,sarvesh,56114,35490,20624,4457
987654457,sarvesh,52825,20260,32565,4457
987654457,sarvesh,52550,20920,31630,4457
987654457,sarvesh,63572,33240,30332,4457
987654457,sarvesh,59656,35040,24616,4457
987654457,sarvesh,66652,37470,29182,4457
987654457,sarvesh,65882,49870,16012,4457
987654457,sarvesh,80105,60950,19155,4457
987654457,sarvesh,52946,21010,31936,4457
987654457,sarvesh,69930,64990,4940,4457
987654457,sarvesh,68313,34190,34123,4457
987654457,sarvesh,56983,55760,1223,4457
987654457,sarvesh,67587,65760,1827,4457
987654457,sarvesh,67048,60430,6618,4457
987654458,rakesh sarkar,46192,38640,7552,4458
987654458,rakesh sarkar,56521,46480,10041,4458
987654458,rakesh sarkar,46313,20600,25713,4458
987654458,rakesh sarkar,41792,33360,8432,4458
987654458,rakesh sarkar,51571,29290,22281,4458
987654458,rakesh sarkar,58402,38230,20172,4458
987654458,rakesh sarkar,53617,47750,5867,4458
987654458,rakesh sarkar,77476,51770,25706,4458
987654458,rakesh sarkar,62296,39520,22776,4458
987654458,rakesh sarkar,55619,33930,21689,4458
987654458,rakesh sarkar,63902,60200,3702,4458
987654458,rakesh sarkar,71140,62210,8930,4458
987654458,rakesh sarkar,47259,19400,27859,4458
987654458,rakesh sarkar,63286,20970,42316,4458
987654458,rakesh sarkar,49954,44000,5954,4458
987654458,rakesh sarkar,57280,30320,26960,4458
987654458,rakesh sarkar,68192,67580,612,4458
987654458,rakesh sarkar,83471,32910,50561,4458
987654458,rakesh sarkar,54596,39800,14796,4458
987654458,rakesh sarkar,54002,28320,25682,4458
987654458,rakesh sarkar,46456,15060,31396,4458
987654458,rakesh sarkar,75562,25890,49672,4458
987654458,rakesh sarkar,67807,44360,23447,4458
987654458,rakesh sarkar,52737,17070,35667,4458
987654459,akash gupta,57709,42650,15059,4459
987654459,akash gupta,92546,65420,27126,4459
987654459,akash gupta,94647,80020,14627,4459
987654459,akash gupta,71382,56820,14562,4459
987654459,akash gupta,76222,21670,54552,4459
987654459,akash gupta,72339,68820,3519,4459
987654459,akash gupta,77245,38530,38715,4459
987654459,akash gupta,84857,22190,62667,4459
987654459,akash gupta,97243,49040,48203,4459
987654459,akash gupta,66531,47940,18591,4459
987654459,akash gupta,57401,15630,41771,4459
987654459,akash gupta,50911,24680,26231,4459
987654459,akash gupta,58028,48250,9778,4459
987654459,akash gupta,62076,36300,25776,4459
987654459,akash gupta,57302,50750,6552,4459
987654459,akash gupta,58292,23580,34712,4459
987654459,akash gupta,80919,62580,18339,4459
987654459,akash gupta,73395,44030,29365,4459
987654459,akash gupta,71932,19460,52472,4459
987654459,akash gupta,81832,33080,48752,4459
987654459,akash gupta,81920,42080,39840,4459
987654459,akash gupta,71767,58950,12817,4459
987654459,akash gupta,81711,44560,37151,4459
987654459,akash gupta,79412,37160,42252,4459
987654460,rahul,75782,43290,32492,4460
987654460,rahul,71074,30150,40924,4460
987654460,rahul,85594,77280,8314,4460
987654460,rahul,58787,50620,8167,4460
987654460,rahul,61427,30780,30647,4460
987654460,rahul,52363,18250,34113,4460
987654460,rahul,58820,39990,18830,4460
987654460,rahul,58270,46280,11990,4460
987654460,rahul,58886,23940,34946,4460
987654460,rahul,53925,38240,15685,4460
987654460,rahul,68709,22630,46079,4460
987654460,rahul,63506,26570,36936,4460
987654460,rahul,68566,66020,2546,4460
987654460,rahul,77179,70300,6879,4460
987654460,rahul,75001,57740,17261,4460
987654460,rahul,61251,21200,40051,4460
987654460,rahul,71558,62650,8908,4460
987654460,rahul,65057,21860,43197,4460
987654460,rahul,54695,20790,33905,4460
987654460,rahul,69721,54630,15091,4460
987654460,rahul,81898,24730,57168,4460
987654460,rahul,47919,45140,2779,4460
987654460,rahul,61647,26470,35177,4460
987654460,rahul,56070,18910,37160,4460
987654461,pintu thakur,48502,25320,23182,4461
987654461,pintu thakur,54090,16580,37510,4461
987654461,pintu thakur,52880,27720,25160,4461
987654461,pintu thakur,55762,47970,7792,4461
987654461,pintu thakur,66729,29970,36759,4461
987654461,pintu thakur,64276,45590,18686,4461
987654461,pintu thakur,52583,25330,27253,4461
987654461,pintu thakur,61724,34580,27144,4461
987654461,pintu thakur,81590,47890,33700,4461
987654461,pintu thakur,53056,18110,34946,4461
987654461,pintu thakur,58567,21470,37097,4461
987654461,pintu thakur,53716,50740,2976,4461
987654461,pintu thakur,49668,40260,9408,4461
987654461,pintu thakur,53452,18050,35402,4461
987654461,pintu thakur,60811,22650,38161,4461
987654461,pintu thakur,53958,15000,38958,4461
987654461,pintu thakur,66729,36140,30589,4461
987654461,pintu thakur,69754,18530,51224,4461
987654461,pintu thakur,65013,53060,11953,4461
987654461,pintu thakur,69358,26960,42398,4461
987654461,pintu thakur,81535,76910,4625,4461
987654461,pintu thakur,65706,45440,20266,4461
987654461,pintu thakur,78675,20560,58115,4461
987654461,pintu thakur,76882,64860,12022,4461
987654462,vivek,74770,68390,6380,4462
987654462,vivek,80402,67140,13262,4462
987654462,vivek,45323,22050,23273,4462
987654462,vivek,52330,23130,29200,4462
987654462,vivek,50097,39210,10887,4462
987654462,vivek,51549,42430,9119,4462
987654462,vivek,52737,25450,27287,4462
987654462,vivek,57027,41660,15367,4462
987654462,vivek,55905,44020,11885,4462
987654462,vivek,60712,40410,20302,4462
987654462,vivek,60701,28870,31831,4462
987654462,vivek,62934,16930,46004,4462
987654462,vivek,67444,37540,29904,4462
987654462,vivek,83493,27870,55623,4462
987654462,vivek,50691,24880,25811,4462
987654462,vivek,60261,43370,16891,4462
987654462,vivek,49712,40820,8892,4462
987654462,vivek,60448,60330,118,4462
987654462,vivek,52715,33990,18725,4462
987654462,vivek,58699,48730,9969,4462
987654462,vivek,46588,25370,21218,4462
987654462,vivek,59381,25430,33951,4462
987654462,vivek,64320,27640,36680,4462
987654462,vivek,59447,48670,10777,4462
987654463,mohd khairul,65387,17060,48327,4463
987654463,mohd khairul,77443,23550,53893,4463
987654463,mohd khairul,48172,17940,30232,4463
987654463,mohd khairul,58006,39740,18266,4463
987654463,mohd khairul,44553,13350,31203,4463
987654463,mohd khairul,41385,22910,18475,4463
987654463,mohd khairul,49536,23430,26106,4463
987654463,mohd khairul,47886,28390,19496,4463
987654463,mohd khairul,39317,33400,5917,4463
987654463,mohd khairul,51582,50420,1162,4463
987654463,mohd khairul,57082,22700,34382,4463
987654463,mohd khairul,55663,21900,33763,4463
987654463,mohd khairul,55564,34880,20684,4463
987654463,mohd khairul,71030,63380,7650,4463
987654463,mohd khairul,49338,13470,35868,4463
987654463,mohd khairul,57335,51520,5815,4463
987654463,mohd khairul,46346,36150,10196,4463
987654463,mohd khairul,52781,28710,24071,4463
987654463,mohd khairul,51472,14590,36882,4463
987654463,mohd khairul,62351,15600,46751,4463
987654463,mohd khairul,48700,30220,18480,4463
987654463,mohd khairul,62593,23270,39323,4463
987654463,mohd khairul,60052,30080,29972,4463
987654463,mohd khairul,64001,36610,27391,4463
987654464,farmaan khan,68291,35110,33181,4464
987654464,farmaan khan,77619,64960,12659,4464
987654464,farmaan khan,58204,42070,16134,4464
987654464,farmaan khan,77047,56350,20697,4464
987654464,farmaan khan,73087,35020,38067,4464
987654464,farmaan khan,69556,65190,4366,4464
987654464,farmaan khan,73065,40290,32775,4464
987654464,farmaan khan,92722,48840,43882,4464
987654464,farmaan khan,59799,40420,19379,4464
987654464,farmaan khan,55377,54720,657,4464
987654464,farmaan khan,53243,42800,10443,4464
987654464,farmaan khan,56136,47650,8486,4464
987654464,farmaan khan,51032,21180,29852,4464
987654464,farmaan khan,62813,41020,21793,4464
987654464,farmaan khan,51582,18460,33122,4464
987654464,farmaan khan,70744,61270,9474,4464
987654464,farmaan khan,66850,22600,44250,4464
987654464,farmaan khan,74066,59970,14096,4464
987654464,farmaan khan,73824,71670,2154,4464
987654464,farmaan khan,81326,75760,5566,4464
987654464,farmaan khan,51582,22310,29272,4464
987654464,farmaan khan,58721,14690,44031,4464
987654464,farmaan khan,51703,32410,19293,4464
987654464,farmaan khan,39317,25900,13417,4464
987654465,vansu dev,53210,30770,22440,4465
987654465,vansu dev,61834,32730,29104,4465
987654465,vansu dev,55498,49660,5838,4465
987654465,vansu dev,57016,47610,9406,4465
987654465,vansu dev,62087,33400,28687,4465
987654465,vansu dev,65541,54990,10551,4465
987654465,vansu dev,68192,65550,2642,4465
987654465,vansu dev,84857,43270,41587,4465
987654465,vansu dev,50746,18730,32016,4465
987654465,vansu dev,50966,25260,25706,4465
987654465,vansu dev,51043,38850,12193,4465
987654465,vansu dev,53133,44820,8313,4465
987654465,vansu dev,59942,28650,31292,4465
987654465,vansu dev,62593,45320,17273,4465
987654465,vansu dev,47182,13370,33812,4465
987654465,vansu dev,62296,49360,12936,4465
987654465,vansu dev,60404,26470,33934,4465
987654465,vansu dev,64243,30630,33613,4465
987654465,vansu dev,74330,22570,51760,4465
987654465,vansu dev,75056,36740,38316,4465
987654465,vansu dev,57148,17760,39388,4465
987654465,vansu dev,55597,28570,27027,4465
987654465,vansu dev,63286,41310,21976,4465
987654465,vansu dev,56873,33240,23633,4465
987654466,vansu dev,63462,37390,26072,4466
987654466,vansu dev,57159,42750,14409,4466
987654466,vansu dev,76057,64650,11407,4466
987654466,vansu dev,73901,52880,21021,4466
987654466,vansu dev,70546,44440,26106,4466
987654466,vansu dev,71481,41390,30091,4466
987654466,vansu dev,101401,33790,67611,4466
987654466,vansu dev,58622,26400,32222,4466
987654466,vansu dev,72944,39230,33714,4466
987654466,vansu dev,57610,55060,2550,4466
987654466,vansu dev,58413,46550,11863,4466
987654466,vansu dev,67972,28750,39222,4466
987654466,vansu dev,55454,15820,39634,4466
987654466,vansu dev,64870,34100,30770,4466
987654466,vansu dev,60008,24050,35958,4466
987654466,vansu dev,63044,35410,27634,4466
987654466,vansu dev,72801,30090,42711,4466
987654466,vansu dev,86760,58920,27840,4466
987654466,vansu dev,50768,42830,7938,4466
987654466,vansu dev,55333,48520,6813,4466
987654466,vansu dev,51527,42740,8787,4466
987654466,vansu dev,55102,41650,13452,4466
987654466,vansu dev,60261,19430,40831,4466
987654466,vansu dev,48524,26210,22314,4466
987654467,shyam kumar,51032,15710,35322,4467
987654467,shyam kumar,72097,35380,36717,4467
987654467,shyam kumar,69149,38500,30649,4467
987654467,shyam kumar,70172,18840,51332,4467
987654467,shyam kumar,75287,66300,8987,4467
987654467,shyam kumar,84934,68330,16604,4467
987654467,shyam kumar,56356,52240,4116,4467
987654467,shyam kumar,89675,81150,8525,4467
987654467,shyam kumar,77146,32320,44826,4467
987654467,shyam kumar,73615,46870,26745,4467
987654467,shyam kumar,87090,37100,49990,4467
987654467,shyam kumar,52924,24800,28124,4467
987654467,shyam kumar,54376,22270,32106,4467
987654467,shyam kumar,49943,15990,33953,4467
987654467,shyam kumar,51912,30660,21252,4467
987654467,shyam kumar,65739,37490,28249,4467
987654467,shyam kumar,68137,67080,1057,4467
987654467,shyam kumar,68830,63910,4920,4467
987654467,shyam kumar,61999,52180,9819,4467
987654467,shyam kumar,67037,25070,41967,4467
987654467,shyam kumar,70689,59920,10769,4467
987654467,shyam kumar,50020,35200,14820,4467
987654467,shyam kumar,49096,17380,31716,4467
987654467,shyam kumar,50504,22490,28014,4467
987654468,shafibul,45752,15880,29872,4468
987654468,shafibul,49855,39180,10675,4468
987654468,shafibul,53188,52160,1028,4468
987654468,shafibul,52638,23980,28658,4468
987654468,shafibul,65332,26850,38482,4468
987654468,shafibul,64958,37500,27458,4468
987654468,shafibul,71019,28100,42919,4468
987654468,shafibul,77608,70450,7158,4468
987654468,shafibul,92898,40490,52408,4468
987654468,shafibul,53397,17050,36347,4468
987654468,shafibul,51901,28200,23701,4468
987654468,shafibul,53034,14690,38344,4468
987654468,shafibul,48656,20960,27696,4468
987654468,shafibul,48414,14420,33994,4468
987654468,shafibul,53837,35030,18807,4468
987654468,shafibul,51725,48430,3295,4468
987654468,shafibul,55575,44950,10625,4468
987654468,shafibul,49052,18230,30822,4468
987654468,shafibul,64782,64200,582,4468
987654468,shafibul,63781,57710,6071,4468
987654468,shafibul,72823,51490,21333,4468
987654468,shafibul,50284,49220,1064,4468
987654468,shafibul,55751,28360,27391,4468
987654468,shafibul,53595,27730,25865,4468
987654469,lalit kathuriya,53793,39420,14373,4469
987654469,lalit kathuriya,54233,50390,3843,4469
987654469,lalit kathuriya,61240,30900,30340,4469
987654469,lalit kathuriya,52429,25710,26719,4469
987654469,lalit kathuriya,61372,53910,7462,4469
987654469,lalit kathuriya,67499,31940,35559,4469
987654469,lalit kathuriya,65805,43830,21975,4469
987654469,lalit kathuriya,66080,45040,21040,4469
987654469,lalit kathuriya,85451,81190,4261,4469
987654469,lalit kathuriya,57665,39650,18015,4469
987654469,lalit kathuriya,63011,47880,15131,4469
987654469,lalit kathuriya,52583,20480,32103,4469
987654469,lalit kathuriya,46863,28970,17893,4469
987654469,lalit kathuriya,55465,18500,36965,4469
987654469,lalit kathuriya,58589,33630,24959,4469
987654469,lalit kathuriya,45499,28860,16639,4469
987654469,lalit kathuriya,63396,43320,20076,4469
987654469,lalit kathuriya,55740,33040,22700,4469
987654469,lalit kathuriya,61251,28560,32691,4469
987654469,lalit kathuriya,67488,51700,15788,4469
987654469,lalit kathuriya,91314,52970,38344,4469
987654469,lalit kathuriya,48447,26470,21977,4469
987654469,lalit kathuriya,54992,20030,34962,4469
987654469,lalit kathuriya,48546,47750,796,4469
987654470,pooran chand,52033,43750,8283,4470
987654470,pooran chand,59172,48730,10442,4470
987654470,pooran chand,52979,40460,12519,4470
987654470,pooran chand,52902,50160,2742,4470
987654470,pooran chand,51626,40650,10976,4470
987654470,pooran chand,66454,19150,47304,4470
987654470,pooran chand,55762,22300,33462,4470
987654470,pooran chand,71261,36860,34401,4470
987654470,pooran chand,96418,89160,7258,4470
987654470,pooran chand,49063,34450,14613,4470
987654470,pooran chand,63957,28320,35637,4470
987654470,pooran chand,52352,19550,32802,4470
987654470,pooran chand,47710,46530,1180,4470
987654470,pooran chand,48645,30060,18585,4470
987654470,pooran chand,50053,22780,27273,4470
987654470,pooran chand,51802,46510,5292,4470
987654470,pooran chand,60294,42140,18154,4470
987654470,pooran chand,61603,53320,8283,4470
987654470,pooran chand,61240,53560,7680,4470
987654470,pooran chand,70964,27130,43834,4470
987654470,pooran chand,87662,49020,38642,4470
987654470,pooran chand,52748,24550,28198,4470
987654470,pooran chand,51054,20910,30144,4470
987654470,pooran chand,47149,17240,29909,4470
987654471,aamir hussain,43629,31030,12599,4471
987654471,aamir hussain,50812,42770,8042,4471
987654471,aamir hussain,56884,51830,5054,4471
987654471,aamir hussain,49624,42080,7544,4471
987654471,aamir hussain,65409,55680,9729,4471
987654471,aamir hussain,56279,25470,30809,4471
987654471,aamir hussain,62230,44000,18230,4471
987654471,aamir hussain,71250,23240,48010,4471
987654471,aamir hussain,91655,65130,26525,4471
987654471,aamir hussain,54288,34130,20158,4471
987654471,aamir hussain,55212,35310,19902,4471
987654471,aamir hussain,49943,37380,12563,4471
987654471,aamir hussain,44762,23100,21662,4471
987654471,aamir hussain,82855,79450,3405,4471
987654471,aamir hussain,52462,18870,33592,4471
987654471,aamir hussain,56114,47130,8984,4471
987654471,aamir hussain,43145,28830,14315,4471
987654471,aamir hussain,104954,67560,37394,4471
987654471,aamir hussain,77157,63860,13297,4471
987654471,aamir hussain,91028,89320,1708,4471
987654471,aamir hussain,82976,75070,7906,4471
987654471,aamir hussain,86903,28780,58123,4471
987654471,aamir hussain,89279,39220,50059,4471
987654471,aamir hussain,100433,56900,43533,4471
987654472,kamal jit singh,62659,34060,28599,4472
987654472,kamal jit singh,66333,45150,21183,4472
987654472,kamal jit singh,62373,34900,27473,4472
987654472,kamal jit singh,55102,41370,13732,4472
987654472,kamal jit singh,65068,24190,40878,4472
987654472,kamal jit singh,55476,28360,27116,4472
987654472,kamal jit singh,54706,40870,13836,4472
987654472,kamal jit singh,65387,28070,37317,4472
987654472,kamal jit singh,69303,55730,13573,4472
987654472,kamal jit singh,58281,39260,19021,4472
987654472,kamal jit singh,79533,31920,47613,4472
987654472,kamal jit singh,89191,30860,58331,4472
987654472,kamal jit singh,74506,58440,16066,4472
987654472,kamal jit singh,65508,55070,10438,4472
987654472,kamal jit singh,59722,54810,4912,4472
987654472,kamal jit singh,60536,26070,34466,4472
987654472,kamal jit singh,55443,45290,10153,4472
987654472,kamal jit singh,63165,46550,16615,4472
987654472,kamal jit singh,49459,18620,30839,4472
987654472,kamal jit singh,62505,43950,18555,4472
987654472,kamal jit singh,60734,29890,30844,4472
987654472,kamal jit singh,62010,53790,8220,4472
987654472,kamal jit singh,67510,38260,29250,4472
987654472,kamal jit singh,83383,81280,2103,4472
987654473,shiv kumar,56092,31560,24532,4473
987654473,shiv kumar,55190,14980,40210,4473
987654473,shiv kumar,50339,37080,13259,4473
987654473,shiv kumar,50691,41670,9021,4473
987654473,shiv kumar,46379,20930,25449,4473
987654473,shiv kumar,55322,18240,37082,4473
987654473,shiv kumar,50207,16890,33317,4473
987654473,shiv kumar,65255,53180,12075,4473
987654473,shiv kumar,62252,20720,41532,4473
987654473,shiv kumar,62868,34180,28688,4473
987654473,shiv kumar,75144,66930,8214,4473
987654473,shiv kumar,70359,30730,39629,4473
987654473,shiv kumar,55245,43770,11475,4473
987654473,shiv kumar,59590,47810,11780,4473
987654473,shiv kumar,56103,47270,8833,4473
987654473,shiv kumar,53727,29030,24697,4473
987654473,shiv kumar,50812,40800,10012,4473
987654473,shiv kumar,52770,42710,10060,4473
987654473,shiv kumar,49030,15330,33700,4473
987654473,shiv kumar,61592,27250,34342,4473
987654473,shiv kumar,63759,58310,5449,4473
987654473,shiv kumar,61350,41320,20030,4473
987654473,shiv kumar,66817,28350,38467,4473
987654473,shiv kumar,78169,75020,3149,4473
987654474,mayank chaudhary,47523,22140,25383,4474
987654474,mayank chaudhary,47314,44880,2434,4474
987654474,mayank chaudhary,45708,18800,26908,4474
987654474,mayank chaudhary,38371,32070,6301,4474
987654474,mayank chaudhary,46852,32330,14522,4474
987654474,mayank chaudhary,52979,30980,21999,4474
987654474,mayank chaudhary,40164,26920,13244,4474
987654474,mayank chaudhary,54376,23800,30576,4474
987654474,mayank chaudhary,55817,15870,39947,4474
987654474,mayank chaudhary,54486,27120,27366,4474
987654474,mayank chaudhary,65068,30820,34248,4474
987654474,mayank chaudhary,78983,47760,31223,4474
987654474,mayank chaudhary,53243,36350,16893,4474
987654474,mayank chaudhary,66267,61280,4987,4474
987654474,mayank chaudhary,63253,28500,34753,4474
987654474,mayank chaudhary,61042,48990,12052,4474
987654474,mayank chaudhary,60745,50970,9775,4474
987654474,mayank chaudhary,51571,25120,26451,4474
987654474,mayank chaudhary,56048,43400,12648,4474
987654474,mayank chaudhary,55993,51570,4423,4474
987654474,mayank chaudhary,59029,48590,10439,4474
987654474,mayank chaudhary,64474,21800,42674,4474
987654474,mayank chaudhary,80743,74470,6273,4474
987654474,mayank chaudhary,45587,15880,29707,4474
987654475,rohit,51868,47170,4698,4475
987654475,rohit,46335,20700,25635,4475
987654475,rohit,50064,23740,26324,4475
987654475,rohit,48414,36220,12194,4475
987654475,rohit,59535,44250,15285,4475
987654475,rohit,46962,32060,14902,4475
987654475,rohit,60778,46110,14668,4475
987654475,rohit,62571,33020,29551,4475
987654475,rohit,54376,22040,32336,4475
987654475,rohit,65387,44760,20627,4475
987654475,rohit,82426,20960,61466,4475
987654475,rohit,49217,15520,33697,4475
987654475,rohit,50482,23460,27022,4475
987654475,rohit,51967,31830,20137,4475
987654475,rohit,45840,26460,19380,4475
987654475,rohit,54728,16960,37768,4475
987654475,rohit,51494,26530,24964,4475
987654475,rohit,51967,27130,24837,4475
987654475,rohit,71008,37030,33978,4475
987654475,rohit,61438,46490,14948,4475
987654475,rohit,63781,48990,14791,4475
987654475,rohit,69930,18150,51780,4475
987654475,rohit,72548,64990,7558,4475
987654475,rohit,55432,34800,20632,4475
987654476,som dutt,50592,31280,19312,4476
987654476,som dutt,48029,31950,16079,4476
987654476,som dutt,51879,40220,11659,4476
987654476,som dutt,48843,46240,2603,4476
987654476,som dutt,50196,45050,5146,4476
987654476,som dutt,51813,32490,19323,4476
987654476,som dutt,61724,36950,24774,4476
987654476,som dutt,57412,15050,42362,4476
987654476,som dutt,65772,23660,42112,4476
987654476,som dutt,74671,49840,24831,4476
987654476,som dutt,88762,28020,60742,4476
987654476,som dutt,51208,45530,5678,4476
987654476,som dutt,53199,43540,9659,4476
987654476,som dutt,51989,34010,17979,4476
987654476,som dutt,55784,48370,7414,4476
987654476,som dutt,55168,18660,36508,4476
987654476,som dutt,60624,48240,12384,4476
987654476,som dutt,41935,13060,28875,4476
987654476,som dutt,55652,14170,41482,4476
987654476,som dutt,64551,41280,23271,4476
987654476,som dutt,65145,55300,9845,4476
987654476,som dutt,70238,48200,22038,4476
987654476,som dutt,81128,36410,44718,4476
987654476,som dutt,43277,20000,23277,4476
987654477,bablu regar,46984,24790,22194,4477
987654477,bablu regar,46698,17100,29598,4477
987654477,bablu regar,45840,15810,30030,4477
987654477,bablu regar,49382,31920,17462,4477
987654477,bablu regar,50163,26630,23533,4477
987654477,bablu regar,43607,11310,32297,4477
987654477,bablu regar,67422,27030,40392,4477
987654477,bablu regar,55608,20460,35148,4477
987654477,bablu regar,57280,44040,13240,4477
987654477,bablu regar,67103,38810,28293,4477
987654477,bablu regar,79049,26330,52719,4477
987654477,bablu regar,45070,36370,8700,4477
987654477,bablu regar,50625,32050,18575,4477
987654477,bablu regar,45851,17790,28061,4477
987654477,bablu regar,47435,46180,1255,4477
987654477,bablu regar,49613,36750,12863,4477
987654477,bablu regar,63792,53100,10692,4477
987654477,bablu regar,47919,47850,69,4477
987654477,bablu regar,62373,23320,39053,4477
987654477,bablu regar,63858,48650,15208,4477
987654477,bablu regar,62076,15680,46396,4477
987654477,bablu regar,64188,48360,15828,4477
987654477,bablu regar,78598,42140,36458,4477
987654477,bablu regar,50790,39170,11620,4477
987654478,rohit,64034,26240,37794,4478
987654478,rohit,52781,37600,15181,4478
987654478,rohit,54233,17780,36453,4478
987654478,rohit,54486,24930,29556,4478
987654478,rohit,65035,34460,30575,4478
987654478,rohit,52825,26020,26805,4478
987654478,rohit,62637,20480,42157,4478
987654478,rohit,58226,34630,23596,4478
987654478,rohit,62747,57110,5637,4478
987654478,rohit,77938,24370,53568,4478
987654478,rohit,86474,73370,13104,4478
987654478,rohit,52495,34200,18295,4478
987654478,rohit,55685,40280,15405,4478
987654478,rohit,51252,45640,5612,4478
987654478,rohit,48139,33140,14999,4478
987654478,rohit,52209,25390,26819,4478
987654478,rohit,60272,36050,24222,4478
987654478,rohit,54453,28820,25633,4478
987654478,rohit,71448,58040,13408,4478
987654478,rohit,65618,24370,41248,4478
987654478,rohit,59920,35860,24060,4478
987654478,rohit,65046,17930,47116,4478
987654478,rohit,71998,58230,13768,4478
987654478,rohit,50933,49450,1483,4478
987654479,rajkumar,67202,46400,20802,4479
987654479,rajkumar,55487,22560,32927,4479
987654479,rajkumar,58105,54780,3325,4479
987654479,rajkumar,58413,21210,37203,4479
987654479,rajkumar,64859,52040,12819,4479
987654479,rajkumar,51527,28860,22667,4479
987654479,rajkumar,56103,55500,603,4479
987654479,rajkumar,40626,12320,28306,4479
987654479,rajkumar,55410,16970,38440,4479
987654479,rajkumar,53386,38810,14576,4479
987654479,rajkumar,46456,38330,8126,4479
987654479,rajkumar,66542,21810,44732,4479
987654479,rajkumar,63990,61540,2450,4479
987654479,rajkumar,58105,46410,11695,4479
987654479,rajkumar,68214,41110,27104,4479
987654479,rajkumar,76508,73210,3298,4479
987654479,rajkumar,49646,20520,29126,4479
987654479,rajkumar,65475,38460,27015,4479
987654479,rajkumar,60239,57780,2459,4479
987654479,rajkumar,57830,26730,31100,4479
987654479,rajkumar,61449,55360,6089,4479
987654479,rajkumar,59392,58500,892,4479
987654479,rajkumar,67389,52390,14999,4479
987654479,rajkumar,76629,30070,46559,4479
987654480,mubarik,82228,46330,35898,4480
987654480,mubarik,80204,55980,24224,4480
987654480,mubarik,44894,43790,1104,4480
987654480,mubarik,53364,48820,4544,4480
987654480,mubarik,58281,37020,21261,4480
987654480,mubarik,57104,23280,33824,4480
987654480,mubarik,58853,40790,18063,4480
987654480,mubarik,81095,59440,21655,4480
987654480,mubarik,45092,27260,17832,4480
987654480,mubarik,52253,28520,23733,4480
987654480,mubarik,46104,14470,31634,4480
987654480,mubarik,48766,15580,33186,4480
987654480,mubarik,50592,28380,22212,4480
987654480,mubarik,50218,34710,15508,4480
987654480,mubarik,47611,31250,16361,4480
987654480,mubarik,67136,42460,24676,4480
987654480,mubarik,51659,29720,21939,4480
987654480,mubarik,61031,40310,20721,4480
987654480,mubarik,63682,20820,42862,4480
987654480,mubarik,78037,33810,44227,4480
987654480,mubarik,50757,17720,33037,4480
987654480,mubarik,49899,31660,18239,4480
987654480,mubarik,49921,28870,21051,4480
987654480,mubarik,51362,24220,27142,4480
987654481,niraj,63297,44570,18727,4481
987654481,niraj,63979,20470,43509,4481
987654481,niraj,79753,73520,6233,4481
987654481,niraj,62109,18050,44059,4481
987654481,niraj,60525,18010,42515,4481
987654481,niraj,71723,65400,6323,4481
987654481,niraj,47215,20460,26755,4481
987654481,niraj,56818,15230,41588,4481
987654481,niraj,50933,37440,13493,4481
987654481,niraj,43277,22260,21017,4481
987654481,niraj,61504,44070,17434,4481
987654481,niraj,74506,47560,26946,4481
987654481,niraj,42815,27190,15625,4481
987654481,niraj,56565,45280,11285,4481
987654481,niraj,54134,18540,35594,4481
987654481,niraj,50779,28180,22599,4481
987654481,niraj,52957,41570,11387,4481
987654481,niraj,59491,37140,22351,4481
987654481,niraj,46423,31910,14513,4481
987654481,niraj,58930,33940,24990,4481
987654481,niraj,60140,19370,40770,4481
987654481,niraj,56345,22640,33705,4481
987654481,niraj,77113,73100,4013,4481
987654481,niraj,80160,38510,41650,4481
987654482,sarbjeet ,50900,45010,5890,4482
987654482,sarbjeet ,52605,28120,24485,4482
987654482,sarbjeet ,51571,42750,8821,4482
987654482,sarbjeet ,48634,46740,1894,4482
987654482,sarbjeet ,48513,17760,30753,4482
987654482,sarbjeet ,53122,17490,35632,4482
987654482,sarbjeet ,49954,33830,16124,4482
987654482,sarbjeet ,58215,23280,34935,4482
987654482,sarbjeet ,65739,19900,45839,4482
987654482,sarbjeet ,57280,31790,25490,4482
987654482,sarbjeet ,66619,33600,33019,4482
987654482,sarbjeet ,82525,44630,37895,4482
987654482,sarbjeet ,47820,29290,18530,4482
987654482,sarbjeet ,48315,40110,8205,4482
987654482,sarbjeet ,45301,37520,7781,4482
987654482,sarbjeet ,54563,24550,30013,4482
987654482,sarbjeet ,49646,16750,32896,4482
987654482,sarbjeet ,48843,45020,3823,4482
987654482,sarbjeet ,49327,15460,33867,4482
987654482,sarbjeet ,62285,40320,21965,4482
987654482,sarbjeet ,64298,33690,30608,4482
987654482,sarbjeet ,61009,39330,21679,4482
987654482,sarbjeet ,59733,45670,14063,4482
987654482,sarbjeet ,83867,72610,11257,4482
987654483,axat,48007,20080,27927,4483
987654483,axat,49250,47360,1890,4483
987654483,axat,53617,20940,32677,4483
987654483,axat,43926,28800,15126,4483
987654483,axat,48194,43740,4454,4483
987654483,axat,49459,24250,25209,4483
987654483,axat,52759,30920,21839,4483
987654483,axat,59524,35340,24184,4483
987654483,axat,52176,18070,34106,4483
987654483,axat,57478,19560,37918,4483
987654483,axat,57445,47920,9525,4483
987654483,axat,68038,50250,17788,4483
987654483,axat,48931,14900,34031,4483
987654483,axat,54662,39290,15372,4483
987654483,axat,49140,36740,12400,4483
987654483,axat,51120,15350,35770,4483
987654483,axat,49250,20760,28490,4483
987654483,axat,51615,18760,32855,4483
987654483,axat,48502,12960,35542,4483
987654483,axat,61196,31690,29506,4483
987654483,axat,59689,31700,27989,4483
987654483,axat,62736,15960,46776,4483
987654483,axat,59414,34640,24774,4483
987654483,axat,85924,22330,63594,4483
987654484,amit,46896,40360,6536,4484
987654484,amit,56334,38110,18224,4484
987654484,amit,51505,42920,8585,4484
987654484,amit,53012,14150,38862,4484
987654484,amit,98629,29290,69339,4484
987654484,amit,88036,45320,42716,4484
987654484,amit,101676,65260,36416,4484
987654484,amit,97122,94560,2562,4484
987654484,amit,112577,98340,14237,4484
987654484,amit,57115,47800,9315,4484
987654484,amit,66938,61210,5728,4484
987654484,amit,63704,20410,43294,4484
987654484,amit,68291,52980,15311,4484
987654484,amit,69534,42990,26544,4484
987654484,amit,74374,64140,10234,4484
987654484,amit,79423,34590,44833,4484
987654484,amit,84604,32270,52334,4484
987654484,amit,101654,32080,69574,4484
987654484,amit,110168,27820,82348,4484
987654484,amit,102776,34850,67926,4484
987654484,amit,129110,54330,74780,4484
987654484,amit,72812,44280,28532,4484
987654484,amit,74110,51880,22230,4484
987654484,amit,67070,42280,24790,4484
987654485,anubhav shrivastab,69930,22560,47370,4485
987654485,anubhav shrivastab,63968,44380,19588,4485
987654485,anubhav shrivastab,68566,47260,21306,4485
987654485,anubhav shrivastab,56389,44990,11399,4485
987654485,anubhav shrivastab,80501,40210,40291,4485
987654485,anubhav shrivastab,86826,75590,11236,4485
987654485,anubhav shrivastab,85495,38640,46855,4485
987654485,anubhav shrivastab,150824,133870,16954,4485
987654485,anubhav shrivastab,151198,95870,55328,4485
987654485,anubhav shrivastab,72086,28790,43296,4485
987654485,anubhav shrivastab,69105,56950,12155,4485
987654485,anubhav shrivastab,68335,21460,46875,4485
987654485,anubhav shrivastab,59513,33640,25873,4485
987654485,anubhav shrivastab,66586,48380,18206,4485
987654485,anubhav shrivastab,60855,54530,6325,4485
987654485,anubhav shrivastab,72702,52510,20192,4485
987654485,anubhav shrivastab,97276,33400,63876,4485
987654485,anubhav shrivastab,88718,42080,46638,4485
987654485,anubhav shrivastab,110850,28940,81910,4485
987654485,anubhav shrivastab,105966,38210,67756,4485
987654485,anubhav shrivastab,132421,35870,96551,4485
987654485,anubhav shrivastab,68434,21310,47124,4485
987654485,anubhav shrivastab,62230,37120,25110,4485
987654485,anubhav shrivastab,63374,52480,10894,4485
987654486,akkash,68104,32720,35384,4486
987654486,akkash,63572,57850,5722,4486
987654486,akkash,70282,45250,25032,4486
987654486,akkash,60921,33500,27421,4486
987654486,akkash,98816,94950,3866,4486
987654486,akkash,92040,72000,20040,4486
987654486,akkash,111961,67220,44741,4486
987654486,akkash,111510,82310,29200,4486
987654486,akkash,144367,58170,86197,4486
987654486,akkash,77190,59990,17200,4486
987654486,akkash,84395,30630,53765,4486
987654486,akkash,64463,19760,44703,4486
987654486,akkash,70722,70530,192,4486
987654486,akkash,78532,43390,35142,4486
987654486,akkash,64936,21250,43686,4486
987654486,akkash,92777,53980,38797,4486
987654486,akkash,87629,52670,34959,4486
987654486,akkash,102391,58620,43771,4486
987654486,akkash,98002,60680,37322,4486
987654486,akkash,122323,103560,18763,4486
987654486,akkash,68434,60570,7864,4486
987654486,akkash,85330,53330,32000,4486
987654486,akkash,81480,71790,9690,4486
987654486,akkash,62384,46940,15444,4486
987654487,himanshu,76805,19390,57415,4487
987654487,himanshu,68478,37780,30698,4487
987654487,himanshu,97936,50050,47886,4487
987654487,himanshu,96451,41930,54521,4487
987654487,himanshu,102754,85060,17694,4487
987654487,himanshu,96110,34590,61520,4487
987654487,himanshu,125381,66430,58951,4487
987654487,himanshu,85308,73570,11738,4487
987654487,himanshu,125799,114250,11549,4487
987654487,himanshu,106560,36810,69750,4487
987654487,himanshu,111532,66500,45032,4487
987654487,himanshu,126481,87840,38641,4487
987654487,himanshu,60547,47400,13147,4487
987654487,himanshu,61559,61530,29,4487
987654487,himanshu,58424,29950,28474,4487
987654487,himanshu,66124,44840,21284,4487
987654487,himanshu,67609,49480,18129,4487
987654487,himanshu,70656,30830,39826,4487
987654487,himanshu,75991,59890,16101,4487
987654487,himanshu,94416,75160,19256,4487
987654487,himanshu,94702,79770,14932,4487
987654487,himanshu,96484,38060,58424,4487
987654487,himanshu,107605,58500,49105,4487
987654487,himanshu,125227,112470,12757,4487
987654488,harsh dagar,68665,68010,655,4488
987654488,harsh dagar,63187,62480,707,4488
987654488,harsh dagar,73197,43120,30077,4488
987654488,harsh dagar,72878,24260,48618,4488
987654488,harsh dagar,84021,54270,29751,4488
987654488,harsh dagar,106109,72190,33919,4488
987654488,harsh dagar,144950,76410,68540,4488
987654488,harsh dagar,130584,38060,92524,4488
987654488,harsh dagar,141705,78740,62965,4488
987654488,harsh dagar,152540,85000,67540,4488
987654488,harsh dagar,86672,74090,12582,4488
987654488,harsh dagar,75518,41030,34488,4488
987654488,harsh dagar,69754,19040,50714,4488
987654488,harsh dagar,76915,66740,10175,4488
987654488,harsh dagar,63968,52180,11788,4488
987654488,harsh dagar,67378,62560,4818,4488
987654488,harsh dagar,69006,39870,29136,4488
987654488,harsh dagar,92920,77430,15490,4488
987654488,harsh dagar,94614,61980,32634,4488
987654488,harsh dagar,98618,34580,64038,4488
987654488,harsh dagar,112654,50720,61934,4488
987654488,harsh dagar,130188,62220,67968,4488
987654488,harsh dagar,76860,69090,7770,4488
987654488,harsh dagar,72020,23730,48290,4488
987654489,anil kumar,73648,72740,908,4489
987654489,anil kumar,75518,67220,8298,4489
987654489,anil kumar,72845,32800,40045,4489
987654489,anil kumar,81216,70140,11076,4489
987654489,anil kumar,71096,35800,35296,4489
987654489,anil kumar,90181,89570,611,4489
987654489,anil kumar,96572,83790,12782,4489
987654489,anil kumar,93569,87580,5989,4489
987654489,anil kumar,101390,69340,32050,4489
987654489,anil kumar,118253,31380,86873,4489
987654489,anil kumar,74121,50310,23811,4489
987654489,anil kumar,61350,40380,20970,4489
987654489,anil kumar,65288,59980,5308,4489
987654489,anil kumar,64793,52700,12093,4489
987654489,anil kumar,55102,21820,33282,4489
987654489,anil kumar,64892,31810,33082,4489
987654489,anil kumar,69853,64080,5773,4489
987654489,anil kumar,77036,59550,17486,4489
987654489,anil kumar,87024,36150,50874,4489
987654489,anil kumar,86573,32840,53733,4489
987654489,anil kumar,102083,95380,6703,4489
987654489,anil kumar,120376,42000,78376,4489
987654489,anil kumar,72460,54740,17720,4489
987654489,anil kumar,66036,16770,49266,4489
987654490,vijay virmani,68016,62370,5646,4490
987654490,vijay virmani,62659,54390,8269,4490
987654490,vijay virmani,59051,23340,35711,4490
987654490,vijay virmani,63473,39910,23563,4490
987654490,vijay virmani,68764,45610,23154,4490
987654490,vijay virmani,81579,57360,24219,4490
987654490,vijay virmani,85638,66880,18758,4490
987654490,vijay virmani,96572,88840,7732,4490
987654490,vijay virmani,95186,90720,4466,4490
987654490,vijay virmani,118187,104700,13487,4490
987654490,vijay virmani,78224,23400,54824,4490
987654490,vijay virmani,100796,96170,4626,4490
987654490,vijay virmani,84131,60850,23281,4490
987654490,vijay virmani,92612,46930,45682,4490
987654490,vijay virmani,108815,85560,23255,4490
987654490,vijay virmani,103997,35420,68577,4490
987654490,vijay virmani,61977,19950,42027,4490
987654490,vijay virmani,66465,24020,42445,4490
987654490,vijay virmani,62967,59910,3057,4490
987654490,vijay virmani,60173,58360,1813,4490
987654490,vijay virmani,62021,48810,13211,4490
987654490,vijay virmani,68401,24240,44161,4490
987654490,vijay virmani,74660,64690,9970,4490
987654490,vijay virmani,108375,58960,49415,4490
987654491,vivek auhari,89862,23820,66042,4491
987654491,vivek auhari,104415,41150,63265,4491
987654491,vivek auhari,90555,48840,41715,4491
987654491,vivek auhari,121586,78670,42916,4491
987654491,vivek auhari,58204,46890,11314,4491
987654491,vivek auhari,73164,46310,26854,4491
987654491,vivek auhari,82415,58770,23645,4491
987654491,vivek auhari,102732,97890,4842,4491
987654491,vivek auhari,110971,48210,62761,4491
987654491,vivek auhari,137019,126260,10759,4491
987654491,vivek auhari,66828,44740,22088,4491
987654491,vivek auhari,64606,59360,5246,4491
987654491,vivek auhari,53661,17230,36431,4491
987654491,vivek auhari,103766,83240,20526,4491
987654491,vivek auhari,109167,67360,41807,4491
987654491,vivek auhari,78829,39050,39779,4491
987654491,vivek auhari,54904,44770,10134,4491
987654491,vivek auhari,122422,82280,40142,4491
987654491,vivek auhari,107605,83020,24585,4491
987654491,vivek auhari,91215,27210,64005,4491
987654491,vivek auhari,126514,72900,53614,4491
987654491,vivek auhari,133246,47180,86066,4491
987654491,vivek auhari,133851,94140,39711,4491
987654491,vivek auhari,139417,94710,44707,4491
987654492,sachin,162935,55080,107855,4492
987654492,sachin,99762,54700,45062,4492
987654492,sachin,66245,41710,24535,4492
987654492,sachin,77366,35420,41946,4492
987654492,sachin,72251,65690,6561,4492
987654492,sachin,90181,43840,46341,4492
987654492,sachin,84736,38860,45876,4492
987654492,sachin,91039,28160,62879,4492
987654492,sachin,147348,89240,58108,4492
987654492,sachin,125898,116190,9708,4492
987654492,sachin,115261,104980,10281,4492
987654492,sachin,127933,93790,34143,4492
987654492,sachin,148349,88870,59479,4492
987654492,sachin,108562,99240,9322,4492
987654492,sachin,116163,111720,4443,4492
987654492,sachin,106560,73860,32700,4492
987654492,sachin,110850,50910,59940,4492
987654492,sachin,117692,52260,65432,4492
987654492,sachin,119782,115610,4172,4492
987654492,sachin,80468,44640,35828,4492
987654492,sachin,74220,59070,15150,4492
987654492,sachin,67268,21540,45728,4492
987654492,sachin,66685,42130,24555,4492
987654492,sachin,70656,68930,1726,4492
987654493,subhash chand bhatia,75650,51710,23940,4493
987654493,subhash chand bhatia,80820,50340,30480,4493
987654493,subhash chand bhatia,84901,70590,14311,4493
987654493,subhash chand bhatia,88641,32620,56021,4493
987654493,subhash chand bhatia,91633,53820,37813,4493
987654493,subhash chand bhatia,96165,52570,43595,4493
987654493,subhash chand bhatia,99542,63760,35782,4493
987654493,subhash chand bhatia,81304,30530,50774,4493
987654493,subhash chand bhatia,97881,86070,11811,4493
987654493,subhash chand bhatia,98508,68170,30338,4493
987654493,subhash chand bhatia,103667,51840,51827,4493
987654493,subhash chand bhatia,103282,26760,76522,4493
987654493,subhash chand bhatia,125183,90760,34423,4493
987654493,subhash chand bhatia,75661,20790,54871,4493
987654493,subhash chand bhatia,82151,75830,6321,4493
987654493,subhash chand bhatia,73494,23860,49634,4493
987654493,subhash chand bhatia,67796,37350,30446,4493
987654493,subhash chand bhatia,71646,34870,36776,4493
987654493,subhash chand bhatia,80501,43840,36661,4493
987654493,subhash chand bhatia,67730,56030,11700,4493
987654493,subhash chand bhatia,84923,73470,11453,4493
987654493,subhash chand bhatia,83163,81810,1353,4493
987654493,subhash chand bhatia,86914,77800,9114,4493
987654493,subhash chand bhatia,79346,26160,53186,4493
987654494,bhupender,100411,42110,58301,4494
987654494,bhupender,65134,16740,48394,4494
987654494,bhupender,60701,57780,2921,4494
987654494,bhupender,61570,30330,31240,4494
987654494,bhupender,63110,55110,8000,4494
987654494,bhupender,63132,55990,7142,4494
987654494,bhupender,64243,50760,13483,4494
987654494,bhupender,77795,26710,51085,4494
987654494,bhupender,96550,47830,48720,4494
987654494,bhupender,102666,26420,76246,4494
987654494,bhupender,99311,65210,34101,4494
987654494,bhupender,92359,46150,46209,4494
987654494,bhupender,102996,77780,25216,4494
987654494,bhupender,68467,48640,19827,4494
987654494,bhupender,72570,54870,17700,4494
987654494,bhupender,70271,66380,3891,4494
987654494,bhupender,125920,76270,49650,4494
987654494,bhupender,125920,63560,62360,4494
987654494,bhupender,69006,20720,48286,4494
987654494,bhupender,61669,16800,44869,4494
987654494,bhupender,59161,31940,27221,4494
987654494,bhupender,56928,51290,5638,4494
987654494,bhupender,59711,48500,11211,4494
987654494,bhupender,68467,17560,50907,4494
987654495,raghunandan das,69061,43190,25871,4495
987654495,raghunandan das,81766,49630,32136,4495
987654495,raghunandan das,83119,40210,42909,4495
987654495,raghunandan das,83790,29430,54360,4495
987654495,raghunandan das,95032,55550,39482,4495
987654495,raghunandan das,122730,77120,45610,4495
987654495,raghunandan das,62175,30590,31585,4495
987654495,raghunandan das,66014,54550,11464,4495
987654495,raghunandan das,62813,24690,38123,4495
987654495,raghunandan das,69336,59560,9776,4495
987654495,raghunandan das,58446,25440,33006,4495
987654495,raghunandan das,59029,15170,43859,4495
987654495,raghunandan das,57181,16090,41091,4495
987654495,raghunandan das,87211,54960,32251,4495
987654495,raghunandan das,92183,63560,28623,4495
987654495,raghunandan das,95351,53130,42221,4495
987654495,raghunandan das,114469,113920,549,4495
987654495,raghunandan das,122026,99490,22536,4495
987654495,raghunandan das,71195,67270,3925,4495
987654495,raghunandan das,77619,76520,1099,4495
987654495,raghunandan das,67686,38680,29006,4495
987654495,raghunandan das,61108,47380,13728,4495
987654495,raghunandan das,66751,41610,25141,4495
987654495,raghunandan das,79390,50370,29020,4495
987654496,sanjay,66619,61530,5089,4496
987654496,sanjay,82283,72200,10083,4496
987654496,sanjay,94834,60060,34774,4496
987654496,sanjay,96869,36980,59889,4496
987654496,sanjay,108573,106430,2143,4496
987654496,sanjay,108386,37820,70566,4496
987654496,sanjay,53067,26490,26577,4496
987654496,sanjay,66564,24280,42284,4496
987654496,sanjay,61471,36380,25091,4496
987654496,sanjay,61856,49180,12676,4496
987654496,sanjay,55916,18610,37306,4496
987654496,sanjay,69116,26830,42286,4496
987654496,sanjay,58072,44210,13862,4496
987654496,sanjay,86023,51140,34883,4496
987654496,sanjay,84505,81600,2905,4496
987654496,sanjay,87739,73020,14719,4496
987654496,sanjay,96517,74420,22097,4496
987654496,sanjay,124171,88510,35661,4496
987654496,sanjay,61867,19830,42037,4496
987654496,sanjay,85726,41500,44226,4496
987654496,sanjay,95373,53010,42363,4496
987654496,sanjay,100191,92970,7221,4496
987654496,sanjay,90104,65670,24434,4496
987654496,sanjay,112038,106160,5878,4496
987654497,ajay kumar,65992,51860,14132,4497
987654497,ajay kumar,66300,49300,17000,4497
987654497,ajay kumar,57082,53060,4022,4497
987654497,ajay kumar,60239,15670,44569,4497
987654497,ajay kumar,55927,15470,40457,4497
987654497,ajay kumar,72251,37270,34981,4497
987654497,ajay kumar,53848,42720,11128,4497
987654497,ajay kumar,82030,44300,37730,4497
987654497,ajay kumar,91622,37180,54442,4497
987654497,ajay kumar,98904,83810,15094,4497
987654497,ajay kumar,98420,31490,66930,4497
987654497,ajay kumar,104613,44640,59973,4497
987654497,ajay kumar,70788,56810,13978,4497
987654497,ajay kumar,78730,45920,32810,4497
987654497,ajay kumar,70304,48020,22284,4497
987654497,ajay kumar,71514,32280,39234,4497
987654497,ajay kumar,65310,39010,26300,4497
987654497,ajay kumar,70887,27780,43107,4497
987654497,ajay kumar,65893,55520,10373,4497
987654497,ajay kumar,79808,71330,8478,4497
987654497,ajay kumar,86067,85880,187,4497
987654497,ajay kumar,91369,72150,19219,4497
987654497,ajay kumar,90577,84850,5727,4497
987654497,ajay kumar,156995,59690,97305,4497
987654498,yognder,70656,23420,47236,4498
987654498,yognder,73681,46220,27461,4498
987654498,yognder,56103,53140,2963,4498
987654498,yognder,64518,46150,18368,4498
987654498,yognder,60932,43150,17782,4498
987654498,yognder,57962,23190,34772,4498
987654498,yognder,62307,27110,35197,4498
987654498,yognder,92557,67410,25147,4498
987654498,yognder,85462,82050,3412,4498
987654498,yognder,88223,75600,12623,4498
987654498,yognder,102556,73890,28666,4498
987654498,yognder,120596,57120,63476,4498
987654498,yognder,65475,54790,10685,4498
987654498,yognder,63781,29440,34341,4498
987654498,yognder,72845,22950,49895,4498
987654498,yognder,70425,52050,18375,4498
987654498,yognder,72724,69000,3724,4498
987654498,yognder,66410,50910,15500,4498
987654498,yognder,80479,26690,53789,4498
987654498,yognder,88014,58860,29154,4498
987654498,yognder,101665,77800,23865,4498
987654498,yognder,105416,70670,34746,4498
987654498,yognder,134720,133260,1460,4498
987654498,yognder,65035,39840,25195,4498
987654499,subhash,91468,79290,12178,4499
987654499,subhash,73934,23530,50404,4499
987654499,subhash,64881,62520,2361,4499
987654499,subhash,65981,53680,12301,4499
987654499,subhash,68214,20030,48184,4499
987654499,subhash,85451,58180,27271,4499
987654499,subhash,78015,54780,23235,4499
987654499,subhash,90731,70340,20391,4499
987654499,subhash,94240,50800,43440,4499
987654499,subhash,113237,72280,40957,4499
987654499,subhash,59370,38120,21250,4499
987654499,subhash,58963,34800,24163,4499
987654499,subhash,68896,27330,41566,4499
987654499,subhash,63704,53170,10534,4499
987654499,subhash,63429,34050,29379,4499
987654499,subhash,62340,16250,46090,4499
987654499,subhash,69655,52980,16675,4499
987654499,subhash,89279,82080,7199,4499
987654499,subhash,78785,41830,36955,4499
987654499,subhash,92260,74000,18260,4499
987654499,subhash,98486,25560,72926,4499
987654499,subhash,117769,90760,27009,4499
987654499,subhash,69853,52940,16913,4499
987654499,subhash,114766,108470,6296,4499
987654500,arun ,104393,74810,29583,4500
987654500,arun ,99542,31480,68062,4500
987654500,arun ,123973,64560,59413,4500
987654500,arun ,57302,50500,6802,4500
987654500,arun ,61537,19100,42437,4500
987654500,arun ,59887,30870,29017,4500
987654500,arun ,65739,19310,46429,4500
987654500,arun ,65563,45660,19903,4500
987654500,arun ,95538,50120,45418,4500
987654500,arun ,119782,100270,19512,4500
987654500,arun ,119397,54320,65077,4500
987654500,arun ,131761,57440,74321,4500
987654500,arun ,135171,36120,99051,4500
987654500,arun ,67829,57880,9949,4500
987654500,arun ,68390,22920,45470,4500
987654500,arun ,71085,26530,44555,4500
987654500,arun ,77300,58550,18750,4500
987654500,arun ,62846,33990,28856,4500
987654500,arun ,73362,30380,42982,4500
987654500,arun ,61471,28860,32611,4500
987654500,arun ,84384,75060,9324,4500
987654500,arun ,89334,50210,39124,4500
987654500,arun ,80204,41710,38494,4500
987654500,arun ,75243,41070,34173,4500
987654501,rahul,154949,67300,87649,4501
987654501,rahul,65046,42530,22516,4501
987654501,rahul,71833,64470,7363,4501
987654501,rahul,66080,26070,40010,4501
987654501,rahul,69402,29250,40152,4501
987654501,rahul,66619,61750,4869,4501
987654501,rahul,82063,72950,9113,4501
987654501,rahul,65541,51100,14441,4501
987654501,rahul,73934,29590,44344,4501
987654501,rahul,77960,49150,28810,4501
987654501,rahul,84582,23260,61322,4501
987654501,rahul,92832,26980,65852,4501
987654501,rahul,109651,46530,63121,4501
987654501,rahul,54640,30420,24220,4501
987654501,rahul,64782,33760,31022,4501
987654501,rahul,60404,36890,23514,4501
987654501,rahul,57533,35580,21953,4501
987654501,rahul,65563,49240,16323,4501
987654501,rahul,54266,27980,26286,4501
987654501,rahul,61713,59890,1823,4501
987654501,rahul,83746,76690,7056,4501
987654501,rahul,86969,81020,5949,4501
987654501,rahul,94405,87070,7335,4501
987654501,rahul,109079,79220,29859,4501
987654502,vikas,135831,79520,56311,4502
987654502,vikas,71921,67660,4261,4502
987654502,vikas,66234,33020,33214,4502
987654502,vikas,62967,46320,16647,4502
987654502,vikas,62560,50740,11820,4502
987654502,vikas,59975,59850,125,4502
987654502,vikas,58974,50350,8624,4502
987654502,vikas,61702,23040,38662,4502
987654502,vikas,81755,56580,25175,4502
987654502,vikas,83328,23450,59878,4502
987654502,vikas,87805,66870,20935,4502
987654502,vikas,99696,56900,42796,4502
987654502,vikas,125898,83070,42828,4502
987654502,vikas,63979,36410,27569,4502
987654502,vikas,65739,38060,27679,4502
987654502,vikas,64650,33760,30890,4502
987654502,vikas,64342,48570,15772,4502
987654502,vikas,57797,41340,16457,4502
987654502,vikas,68665,56490,12175,4502
987654502,vikas,69006,34920,34086,4502
987654502,vikas,82349,40040,42309,4502
987654502,vikas,101797,81330,20467,4502
987654502,vikas,104459,36990,67469,4502
987654502,vikas,113611,88620,24991,4502
987654503,vinod,145115,50580,94535,4503
987654503,vinod,61944,15870,46074,4503
987654503,vinod,70403,50120,20283,4503
987654503,vinod,56191,39170,17021,4503
987654503,vinod,59458,33230,26228,4503
987654503,vinod,64397,18180,46217,4503
987654503,vinod,59964,52550,7414,4503
987654503,vinod,60712,57190,3522,4503
987654503,vinod,85902,29860,56042,4503
987654503,vinod,86034,28590,57444,4503
987654503,vinod,96594,25510,71084,4503
987654503,vinod,94603,91370,3233,4503
987654503,vinod,132542,84610,47932,4503
987654503,vinod,68819,46330,22489,4503
987654503,vinod,63990,59300,4690,4503
987654503,vinod,53694,37120,16574,4503
987654503,vinod,64144,54330,9814,4503
987654503,vinod,60701,53330,7371,4503
987654503,vinod,55608,54420,1188,4503
987654503,vinod,67004,43490,23514,4503
987654503,vinod,92612,50550,42062,4503
987654503,vinod,87629,30180,57449,4503
987654503,vinod,91160,37270,53890,4503
987654503,vinod,115250,102750,12500,4503
987654504,salman,134258,111400,22858,4504
987654504,salman,73978,40160,33818,4504
987654504,salman,73934,42310,31624,4504
987654504,salman,63737,57590,6147,4504
987654504,salman,51857,21520,30337,4504
987654504,salman,119485,73690,45795,4504
987654504,salman,76882,52130,24752,4504
987654504,salman,87640,48810,38830,4504
987654504,salman,47017,12120,34897,4504
987654504,salman,139714,79110,60604,4504
987654504,salman,111741,75720,36021,4504
987654504,salman,122983,43280,79703,4504
987654504,salman,126250,83260,42990,4504
987654504,salman,145401,107240,38161,4504
987654504,salman,144675,127650,17025,4504
987654504,salman,184297,133570,50727,4504
987654504,salman,93052,52780,40272,4504
987654504,salman,93195,76460,16735,4504
987654504,salman,79445,58040,21405,4504
987654504,salman,87882,43110,44772,4504
987654504,salman,85495,51910,33585,4504
987654504,salman,79269,75450,3819,4504
987654504,salman,82679,46700,35979,4504
987654504,salman,78983,51930,27053,4504
987654505,mohan kumar,99674,38670,61004,4505
987654505,mohan kumar,135974,100730,35244,4505
987654505,mohan kumar,128692,40590,88102,4505
987654505,mohan kumar,151319,149630,1689,4505
987654505,mohan kumar,110476,109320,1156,4505
987654505,mohan kumar,89477,83060,6417,4505
987654505,mohan kumar,93943,41420,52523,4505
987654505,mohan kumar,87684,81720,5964,4505
987654505,mohan kumar,81205,25860,55345,4505
987654505,mohan kumar,91622,70090,21532,4505
987654505,mohan kumar,75232,68240,6992,4505
987654505,mohan kumar,90907,54300,36607,4505
987654505,mohan kumar,85286,64580,20706,4505
987654505,mohan kumar,101203,96160,5043,4505
987654505,mohan kumar,103447,96200,7247,4505
987654505,mohan kumar,115965,53730,62235,4505
987654505,mohan kumar,76761,63760,13001,4505
987654505,mohan kumar,63880,51330,12550,4505
987654505,mohan kumar,67895,28290,39605,4505
987654505,mohan kumar,67323,28700,38623,4505
987654505,mohan kumar,61988,45910,16078,4505
987654505,mohan kumar,71052,45500,25552,4505
987654505,mohan kumar,64683,25600,39083,4505
987654505,mohan kumar,94966,58380,36586,4505
987654506,sandeep meghawal,89444,50900,38544,4506
987654506,sandeep meghawal,95582,93940,1642,4506
987654506,sandeep meghawal,115448,74820,40628,4506
987654506,sandeep meghawal,98970,89320,9650,4506
987654506,sandeep meghawal,65783,46980,18803,4506
987654506,sandeep meghawal,74275,48140,26135,4506
987654506,sandeep meghawal,78653,22810,55843,4506
987654506,sandeep meghawal,71481,38060,33421,4506
987654506,sandeep meghawal,66278,61680,4598,4506
987654506,sandeep meghawal,50647,46510,4137,4506
987654506,sandeep meghawal,68335,52510,15825,4506
987654506,sandeep meghawal,88762,87840,922,4506
987654506,sandeep meghawal,81216,22550,58666,4506
987654506,sandeep meghawal,91622,53190,38432,4506
987654506,sandeep meghawal,93602,79510,14092,4506
987654506,sandeep meghawal,120046,63070,56976,4506
987654506,sandeep meghawal,68126,39740,28386,4506
987654506,sandeep meghawal,65574,29410,36164,4506
987654506,sandeep meghawal,57467,42680,14787,4506
987654506,sandeep meghawal,63550,42740,20810,4506
987654506,sandeep meghawal,55014,50330,4684,4506
987654506,sandeep meghawal,75232,30650,44582,4506
987654506,sandeep meghawal,59832,28030,31802,4506
987654506,sandeep meghawal,88663,82190,6473,4506
987654507,imamudeen,94394,63860,30534,4507
987654507,imamudeen,84648,44470,40178,4507
987654507,imamudeen,94955,24620,70335,4507
987654507,imamudeen,115118,68380,46738,4507
987654507,imamudeen,68423,64470,3953,4507
987654507,imamudeen,78950,44330,34620,4507
987654507,imamudeen,62989,62760,229,4507
987654507,imamudeen,56202,53180,3022,4507
987654507,imamudeen,85418,32590,52828,4507
987654507,imamudeen,70656,60890,9766,4507
987654507,imamudeen,93932,40990,52942,4507
987654507,imamudeen,86463,48110,38353,4507
987654507,imamudeen,83625,58450,25175,4507
987654507,imamudeen,102303,73180,29123,4507
987654507,imamudeen,108419,49150,59269,4507
987654507,imamudeen,59887,32090,27797,4507
987654507,imamudeen,50922,42080,8842,4507
987654507,imamudeen,53727,30780,22947,4507
987654507,imamudeen,60074,18140,41934,4507
987654507,imamudeen,56367,53850,2517,4507
987654507,imamudeen,58886,19120,39766,4507
987654507,imamudeen,61482,33530,27952,4507
987654507,imamudeen,95186,64160,31026,4507
987654507,imamudeen,94757,28300,66457,4507
987654508,sandeep kumar,93228,61680,31548,4508
987654508,sandeep kumar,97419,55460,41959,4508
987654508,sandeep kumar,106384,103280,3104,4508
987654508,sandeep kumar,58193,21540,36653,4508
987654508,sandeep kumar,60206,15390,44816,4508
987654508,sandeep kumar,55267,52630,2637,4508
987654508,sandeep kumar,63451,22040,41411,4508
987654508,sandeep kumar,66366,58890,7476,4508
987654508,sandeep kumar,56510,32920,23590,4508
987654508,sandeep kumar,63495,55840,7655,4508
987654508,sandeep kumar,93789,36100,57689,4508
987654508,sandeep kumar,96517,38270,58247,4508
987654508,sandeep kumar,98992,84950,14042,4508
987654508,sandeep kumar,97342,56110,41232,4508
987654508,sandeep kumar,117637,74900,42737,4508
987654508,sandeep kumar,61955,48370,13585,4508
987654508,sandeep kumar,64914,27470,37444,4508
987654508,sandeep kumar,56895,39230,17665,4508
987654508,sandeep kumar,63704,30300,33404,4508
987654508,sandeep kumar,60943,33180,27763,4508
987654508,sandeep kumar,61570,48190,13380,4508
987654508,sandeep kumar,65673,58430,7243,4508
987654508,sandeep kumar,92205,86920,5285,4508
987654508,sandeep kumar,87673,46440,41233,4508
987654509,tarjan,97639,67200,30439,4509
987654509,tarjan,94867,63180,31687,4509
987654509,tarjan,124314,50040,74274,4509
987654509,tarjan,65453,46340,19113,4509
987654509,tarjan,66652,19240,47412,4509
987654509,tarjan,64815,23260,41555,4509
987654509,tarjan,72405,35600,36805,4509
987654509,tarjan,79269,61860,17409,4509
987654509,tarjan,86276,24090,62186,4509
987654509,tarjan,77663,56530,21133,4509
987654509,tarjan,95384,87600,7784,4509
987654509,tarjan,106780,103790,2990,4509
987654509,tarjan,108397,52760,55637,4509
987654509,tarjan,101269,66360,34909,4509
987654509,tarjan,145742,141230,4512,4509
987654509,tarjan,61603,18470,43133,4509
987654509,tarjan,57951,31140,26811,4509
987654509,tarjan,57907,43990,13917,4509
987654509,tarjan,57511,32620,24891,4509
987654509,tarjan,53595,22170,31425,4509
987654509,tarjan,60657,50060,10597,4509
987654509,tarjan,63418,16060,47358,4509
987654509,tarjan,84637,83160,1477,4509
987654509,tarjan,87409,82740,4669,4509
987654510,kuldeep singh,83812,31680,52132,4510
987654510,kuldeep singh,94097,91960,2137,4510
987654510,kuldeep singh,122125,49690,72435,4510
987654510,kuldeep singh,68093,44020,24073,4510
987654510,kuldeep singh,60393,48100,12293,4510
987654510,kuldeep singh,70018,63460,6558,4510
987654510,kuldeep singh,65563,17000,48563,4510
987654510,kuldeep singh,61240,34230,27010,4510
987654510,kuldeep singh,63572,17890,45682,4510
987654510,kuldeep singh,63055,38200,24855,4510
987654510,kuldeep singh,94845,40800,54045,4510
987654510,kuldeep singh,90918,57350,33568,4510
987654510,kuldeep singh,86485,36670,49815,4510
987654510,kuldeep singh,77190,65280,11910,4510
987654510,kuldeep singh,98376,63840,34536,4510
987654510,kuldeep singh,75804,73340,2464,4510
987654510,kuldeep singh,70975,68750,2225,4510
987654510,kuldeep singh,71503,26360,45143,4510
987654510,kuldeep singh,69358,68540,818,4510
987654510,kuldeep singh,63605,23850,39755,4510
987654510,kuldeep singh,69534,50750,18784,4510
987654510,kuldeep singh,65816,62410,3406,4510
987654510,kuldeep singh,88388,34040,54348,4510
987654510,kuldeep singh,88938,52670,36268,4510
987654511,murari,85869,67630,18239,4511
987654511,murari,93998,59600,34398,4511
987654511,murari,114909,77790,37119,4511
987654511,murari,68368,44540,23828,4511
987654511,murari,64925,17470,47455,4511
987654511,murari,57357,18240,39117,4511
987654511,murari,64617,60390,4227,4511
987654511,murari,69512,38950,30562,4511
987654511,murari,64936,64160,776,4511
987654511,murari,70579,70180,399,4511
987654511,murari,84945,48870,36075,4511
987654511,murari,84703,50300,34403,4511
987654511,murari,89213,88490,723,4511
987654511,murari,95087,39560,55527,4511
987654511,murari,122950,85820,37130,4511
987654511,murari,76409,59300,17109,4511
987654511,murari,96770,74380,22390,4511
987654511,murari,91105,63180,27925,4511
987654511,murari,97925,32700,65225,4511
987654511,murari,97980,49990,47990,4511
987654511,murari,125656,125180,476,4511
987654511,murari,52231,32030,20201,4511
987654511,murari,66707,25380,41327,4511
987654511,murari,70106,22210,47896,4511
987654512,ramvilash,56961,28010,28951,4512
987654512,ramvilash,65651,33870,31781,4512
987654512,ramvilash,61823,33480,28343,4512
987654512,ramvilash,81777,61180,20597,4512
987654512,ramvilash,81733,27350,54383,4512
987654512,ramvilash,88839,45330,43509,4512
987654512,ramvilash,96033,65350,30683,4512
987654512,ramvilash,103634,46830,56804,4512
987654512,ramvilash,66014,32580,33434,4512
987654512,ramvilash,77322,45460,31862,4512
987654512,ramvilash,70337,50410,19927,4512
987654512,ramvilash,60415,49920,10495,4512
987654512,ramvilash,64848,31300,33548,4512
987654512,ramvilash,69941,69250,691,4512
987654512,ramvilash,87563,30190,57373,4512
987654512,ramvilash,108804,54090,54714,4512
987654512,ramvilash,116449,101100,15349,4512
987654512,ramvilash,111125,44400,66725,4512
987654512,ramvilash,75232,27130,48102,4512
987654512,ramvilash,73868,50590,23278,4512
987654512,ramvilash,87486,26640,60846,4512
987654512,ramvilash,92546,41080,51466,4512
987654512,ramvilash,85011,66800,18211,4512
987654512,ramvilash,103810,40710,63100,4512
987654513,jagdish,65640,51070,14570,4513
987654513,jagdish,64111,41950,22161,4513
987654513,jagdish,59843,41780,18063,4513
987654513,jagdish,58688,19580,39108,4513
987654513,jagdish,57379,29190,28189,4513
987654513,jagdish,58435,21520,36915,4513
987654513,jagdish,58776,21560,37216,4513
987654513,jagdish,94966,70840,24126,4513
987654513,jagdish,82272,62820,19452,4513
987654513,jagdish,80754,32840,47914,4513
987654513,jagdish,96935,69100,27835,4513
987654513,jagdish,119155,31340,87815,4513
987654513,jagdish,61779,54320,7459,4513
987654513,jagdish,59755,37210,22545,4513
987654513,jagdish,68247,26740,41507,4513
987654513,jagdish,68225,63020,5205,4513
987654513,jagdish,71932,67070,4862,4513
987654513,jagdish,103370,34990,68380,4513
987654513,jagdish,126459,94210,32249,4513
987654513,jagdish,125271,114490,10781,4513
987654513,jagdish,113358,85820,27538,4513
987654513,jagdish,131761,73600,58161,4513
987654513,jagdish,81623,21540,60083,4513
987654513,jagdish,93261,86780,6481,4513
987654514,vishal ,93899,83650,10249,4514
987654514,vishal ,99311,89600,9711,4514
987654514,vishal ,103755,88660,15095,4514
987654514,vishal ,89499,53570,35929,4514
987654514,vishal ,73681,22710,50971,4514
987654514,vishal ,77036,40860,36176,4514
987654514,vishal ,64881,41240,23641,4514
987654514,vishal ,66531,37020,29511,4514
987654514,vishal ,64672,59940,4732,4514
987654514,vishal ,53133,21000,32133,4514
987654514,vishal ,63638,28150,35488,4514
987654514,vishal ,88608,72640,15968,4514
987654514,vishal ,89103,60530,28573,4514
987654514,vishal ,95912,58210,37702,4514
987654514,vishal ,99465,58650,40815,4514
987654514,vishal ,136139,38910,97229,4514
987654514,vishal ,71371,36040,35331,4514
987654514,vishal ,69292,34730,34562,4514
987654514,vishal ,68390,46550,21840,4514
987654514,vishal ,61471,37000,24471,4514
987654514,vishal ,54629,15130,39499,4514
987654514,vishal ,58204,28580,29624,4514
987654514,vishal ,63561,30670,32891,4514
987654514,vishal ,85935,27850,58085,4514
987654515,mohd shahid,86958,69100,17858,4515
987654515,mohd shahid,86672,29700,56972,4515
987654515,mohd shahid,94284,88230,6054,4515
987654515,mohd shahid,112225,37620,74605,4515
987654515,mohd shahid,59700,48980,10720,4515
987654515,mohd shahid,62087,55400,6687,4515
987654515,mohd shahid,65992,24070,41922,4515
987654515,mohd shahid,59568,47430,12138,4515
987654515,mohd shahid,57566,44340,13226,4515
987654515,mohd shahid,60921,51230,9691,4515
987654515,mohd shahid,65332,52320,13012,4515
987654515,mohd shahid,83625,69990,13635,4515
987654515,mohd shahid,91380,27840,63540,4515
987654515,mohd shahid,90071,66230,23841,4515
987654515,mohd shahid,83273,45630,37643,4515
987654515,mohd shahid,107924,90530,17394,4515
987654515,mohd shahid,75903,49010,26893,4515
987654515,mohd shahid,66784,36100,30684,4515
987654515,mohd shahid,63132,60130,3002,4515
987654515,mohd shahid,50185,23010,27175,4515
987654515,mohd shahid,59744,50260,9484,4515
987654515,mohd shahid,59216,17040,42176,4515
987654515,mohd shahid,62241,46070,16171,4515
987654515,mohd shahid,85308,55830,29478,4515
987654516,ramvilash,84637,71940,12697,4516
987654516,ramvilash,92051,47880,44171,4516
987654516,ramvilash,91842,85660,6182,4516
987654516,ramvilash,123269,73450,49819,4516
987654516,ramvilash,67840,63040,4800,4516
987654516,ramvilash,58864,45560,13304,4516
987654516,ramvilash,57797,54800,2997,4516
987654516,ramvilash,59062,33450,25612,4516
987654516,ramvilash,50449,15090,35359,4516
987654516,ramvilash,59469,33860,25609,4516
987654516,ramvilash,69842,39330,30512,4516
987654516,ramvilash,88069,76860,11209,4516
987654516,ramvilash,83581,68660,14921,4516
987654516,ramvilash,91501,75770,15731,4516
987654516,ramvilash,100334,54630,45704,4516
987654516,ramvilash,121190,65910,55280,4516
987654516,ramvilash,70392,53080,17312,4516
987654516,ramvilash,51142,36730,14412,4516
987654516,ramvilash,53617,38330,15287,4516
987654516,ramvilash,55399,23980,31419,4516
987654516,ramvilash,72064,48510,23554,4516
987654516,ramvilash,62472,27870,34602,4516
987654516,ramvilash,59612,35230,24382,4516
987654516,ramvilash,65607,60150,5457,4516
987654517,kuldeep,72834,48120,24714,4517
987654517,kuldeep,32552,20610,11942,4517
987654517,kuldeep,52605,21890,30715,4517
987654517,kuldeep,44960,19310,25650,4517
987654517,kuldeep,48579,22290,26289,4517
987654517,kuldeep,49778,25600,24178,4517
987654517,kuldeep,52660,37730,14930,4517
987654517,kuldeep,35874,29160,6714,4517
987654517,kuldeep,58886,55670,3216,4517
987654517,kuldeep,67752,17640,50112,4517
987654517,kuldeep,67653,21830,45823,4517
987654517,kuldeep,71679,37330,34349,4517
987654517,kuldeep,79302,61320,17982,4517
987654517,kuldeep,34213,31090,3123,4517
987654517,kuldeep,54871,51950,2921,4517
987654517,kuldeep,55630,47800,7830,4517
987654517,kuldeep,52000,44130,7870,4517
987654517,kuldeep,54585,34120,20465,4517
987654517,kuldeep,62846,58370,4476,4517
987654517,kuldeep,40219,15670,24549,4517
987654517,kuldeep,68852,24850,44002,4517
987654517,kuldeep,67763,34800,32963,4517
987654517,kuldeep,64771,40570,24201,4517
987654517,kuldeep,112005,105000,7005,4517
987654518,talim,95461,71660,23801,4518
987654518,talim,38558,26690,11868,4518
987654518,talim,57632,35190,22442,4518
987654518,talim,56059,39620,16439,4518
987654518,talim,58864,20890,37974,4518
987654518,talim,58886,17160,41726,4518
987654518,talim,51637,34740,16897,4518
987654518,talim,38272,24000,14272,4518
987654518,talim,68709,20010,48699,4518
987654518,talim,65178,42780,22398,4518
987654518,talim,67268,17050,50218,4518
987654518,talim,77861,72640,5221,4518
987654518,talim,88927,52070,36857,4518
987654518,talim,39031,16780,22251,4518
987654518,talim,56268,16230,40038,4518
987654518,talim,55608,16390,39218,4518
987654518,talim,54079,52060,2019,4518
987654518,talim,61922,32690,29232,4518
987654518,talim,67301,29860,37441,4518
987654518,talim,40120,19990,20130,4518
987654518,talim,79852,44390,35462,4518
987654518,talim,73923,52210,21713,4518
987654518,talim,77135,50250,26885,4518
987654518,talim,92095,27700,64395,4518
987654519,nanku prasad,40472,13470,27002,4519
987654519,nanku prasad,70392,68400,1992,4519
987654519,nanku prasad,57346,18870,38476,4519
987654519,nanku prasad,58193,39490,18703,4519
987654519,nanku prasad,63605,60400,3205,4519
987654519,nanku prasad,42408,18270,24138,4519
987654519,nanku prasad,76871,31680,45191,4519
987654519,nanku prasad,72295,50640,21655,4519
987654519,nanku prasad,65706,35400,30306,4519
987654519,nanku prasad,75210,56960,18250,4519
987654519,nanku prasad,91413,39920,51493,4519
987654519,nanku prasad,37194,31710,5484,4519
987654519,nanku prasad,64870,43810,21060,4519
987654519,nanku prasad,68654,41900,26754,4519
987654519,nanku prasad,60778,54070,6708,4519
987654519,nanku prasad,57489,17340,40149,4519
987654519,nanku prasad,42199,24500,17699,4519
987654519,nanku prasad,74891,39500,35391,4519
987654519,nanku prasad,73604,20590,53014,4519
987654519,nanku prasad,69875,46460,23415,4519
987654519,nanku prasad,63649,28520,35129,4519
987654519,nanku prasad,88916,46800,42116,4519
987654519,nanku prasad,54343,19130,35213,4519
987654519,nanku prasad,90368,36930,53438,4519
987654520,bhola sarkar,61526,33800,27726,4520
987654520,bhola sarkar,75430,45350,30080,4520
987654520,bhola sarkar,85726,45920,39806,4520
987654520,bhola sarkar,40703,15910,24793,4520
987654520,bhola sarkar,53408,42530,10878,4520
987654520,bhola sarkar,52154,41570,10584,4520
987654520,bhola sarkar,48953,30880,18073,4520
987654520,bhola sarkar,50273,21830,28443,4520
987654520,bhola sarkar,56818,25980,30838,4520
987654520,bhola sarkar,37711,12830,24881,4520
987654520,bhola sarkar,76497,72210,4287,4520
987654520,bhola sarkar,70040,46850,23190,4520
987654520,bhola sarkar,59722,32310,27412,4520
987654520,bhola sarkar,75672,26420,49252,4520
987654520,bhola sarkar,87486,47570,39916,4520
987654520,bhola sarkar,46434,36760,9674,4520
987654520,bhola sarkar,50647,50340,307,4520
987654520,bhola sarkar,58534,29040,29494,4520
987654520,bhola sarkar,55322,33470,21852,4520
987654520,bhola sarkar,64925,61110,3815,4520
987654520,bhola sarkar,45444,12750,32694,4520
987654520,bhola sarkar,85308,80850,4458,4520
987654520,bhola sarkar,68478,30730,37748,4520
987654520,bhola sarkar,85429,37840,47589,4520
987654521,balraj,98277,69570,28707,4521
987654521,balraj,36963,24850,12113,4521
987654521,balraj,53221,23170,30051,4521
987654521,balraj,54442,33550,20892,4521
987654521,balraj,54167,20010,34157,4521
987654521,balraj,57148,25100,32048,4521
987654521,balraj,61218,52990,8228,4521
987654521,balraj,35082,33780,1302,4521
987654521,balraj,68225,65960,2265,4521
987654521,balraj,61933,26460,35473,4521
987654521,balraj,65794,64950,844,4521
987654521,balraj,77223,37550,39673,4521
987654521,balraj,91886,49100,42786,4521
987654521,balraj,37843,25040,12803,4521
987654521,balraj,54882,22500,32382,4521
987654521,balraj,59843,34120,25723,4521
987654521,balraj,51175,16680,34495,4521
987654521,balraj,53826,27540,26286,4521
987654521,balraj,58765,16170,42595,4521
987654521,balraj,39185,30860,8325,4521
987654521,balraj,69567,69420,147,4521
987654521,balraj,72097,20210,51887,4521
987654521,balraj,73857,23140,50717,4521
987654521,balraj,71613,69270,2343,4521
987654522,ravindra kumar,83735,33550,50185,4522
987654522,ravindra kumar,42892,19950,22942,4522
987654522,ravindra kumar,61251,22140,39111,4522
987654522,ravindra kumar,54255,31220,23035,4522
987654522,ravindra kumar,51373,37980,13393,4522
987654522,ravindra kumar,44938,22330,22608,4522
987654522,ravindra kumar,57170,51380,5790,4522
987654522,ravindra kumar,37700,34070,3630,4522
987654522,ravindra kumar,65706,59410,6296,4522
987654522,ravindra kumar,59777,33090,26687,4522
987654522,ravindra kumar,67246,26970,40276,4522
987654522,ravindra kumar,77894,26890,51004,4522
987654522,ravindra kumar,50570,29920,20650,4522
987654522,ravindra kumar,37414,21840,15574,4522
987654522,ravindra kumar,52176,37360,14816,4522
987654522,ravindra kumar,50306,21200,29106,4522
987654522,ravindra kumar,56235,15510,40725,4522
987654522,ravindra kumar,56884,56490,394,4522
987654522,ravindra kumar,55223,47740,7483,4522
987654522,ravindra kumar,37128,22700,14428,4522
987654522,ravindra kumar,68775,38060,30715,4522
987654522,ravindra kumar,66201,19110,47091,4522
987654522,ravindra kumar,67554,54200,13354,4522
987654522,ravindra kumar,77839,45290,32549,4522
987654523,rohit kumar,82030,39720,42310,4523
987654523,rohit kumar,44828,13560,31268,4523
987654523,rohit kumar,71481,42630,28851,4523
987654523,rohit kumar,68665,61310,7355,4523
987654523,rohit kumar,64925,60960,3965,4523
987654523,rohit kumar,69699,19160,50539,4523
987654523,rohit kumar,69886,48710,21176,4523
987654523,rohit kumar,35093,34550,543,4523
987654523,rohit kumar,54717,27920,26797,4523
987654523,rohit kumar,51428,49640,1788,4523
987654523,rohit kumar,51373,19700,31673,4523
987654523,rohit kumar,49855,12730,37125,4523
987654523,rohit kumar,54662,25040,29622,4523
987654523,rohit kumar,37667,36400,1267,4523
987654523,rohit kumar,74231,57950,16281,4523
987654523,rohit kumar,67708,18480,49228,4523
987654523,rohit kumar,59601,17510,42091,4523
987654523,rohit kumar,67081,23420,43661,4523
987654523,rohit kumar,87365,80980,6385,4523
987654523,rohit kumar,40285,23040,17245,4523
987654523,rohit kumar,64815,27520,37295,4523
987654523,rohit kumar,61196,21130,40066,4523
987654523,rohit kumar,71393,42010,29383,4523
987654523,rohit kumar,70909,18800,52109,4523
987654524,uttam kumar,79731,22970,56761,4524
987654524,uttam kumar,32453,21750,10703,4524
987654524,uttam kumar,50185,28960,21225,4524
987654524,uttam kumar,43409,31430,11979,4524
987654524,uttam kumar,75111,47310,27801,4524
987654524,uttam kumar,74330,39120,35210,4524
987654524,uttam kumar,33993,17230,16763,4524
987654524,uttam kumar,39515,25150,14365,4524
987654524,uttam kumar,98497,71550,26947,4524
987654524,uttam kumar,102831,94740,8091,4524
987654524,uttam kumar,60294,60000,294,4524
987654524,uttam kumar,85517,63900,21617,4524
987654524,uttam kumar,85880,55660,30220,4524
987654524,uttam kumar,84131,83010,1121,4524
987654524,uttam kumar,106208,68560,37648,4524
987654524,uttam kumar,103942,61510,42432,4524
987654524,uttam kumar,48139,34540,13599,4524
987654524,uttam kumar,52484,32900,19584,4524
987654524,uttam kumar,52253,43050,9203,4524
987654524,uttam kumar,58974,22730,36244,4524
987654524,uttam kumar,60734,45710,15024,4524
987654524,uttam kumar,64881,48370,16511,4524
987654524,uttam kumar,43101,27330,15771,4524
987654524,uttam kumar,83581,30230,53351,4524
987654525,babalu sen,72152,32240,39912,4525
987654525,babalu sen,73681,48370,25311,4525
987654525,babalu sen,88322,62310,26012,4525
987654525,babalu sen,100631,78410,22221,4525
987654525,babalu sen,49844,24110,25734,4525
987654525,babalu sen,84131,69310,14821,4525
987654525,babalu sen,72823,65250,7573,4525
987654525,babalu sen,70656,42050,28606,4525
987654525,babalu sen,74132,29970,44162,4525
987654525,babalu sen,92557,53260,39297,4525
987654525,babalu sen,37315,16830,20485,4525
987654525,babalu sen,59898,23890,36008,4525
987654525,babalu sen,53298,26430,26868,4525
987654525,babalu sen,52627,51990,637,4525
987654525,babalu sen,51648,31040,20608,4525
987654525,babalu sen,66575,17320,49255,4525
987654525,babalu sen,38943,20630,18313,4525
987654525,babalu sen,63638,24640,38998,4525
987654525,babalu sen,62560,47790,14770,4525
987654525,babalu sen,67851,41940,25911,4525
987654525,babalu sen,68962,44350,24612,4525
987654525,babalu sen,83361,79960,3401,4525
987654525,babalu sen,42914,30380,12534,4525
987654525,babalu sen,70469,69900,569,4525
987654526,rustam shah,71239,40240,30999,4526
987654526,rustam shah,72933,44290,28643,4526
987654526,rustam shah,77597,58470,19127,4526
987654526,rustam shah,85363,52210,33153,4526
987654526,rustam shah,77267,66650,10617,4526
987654526,rustam shah,56301,34460,21841,4526
987654526,rustam shah,48579,27470,21109,4526
987654526,rustam shah,50108,18840,31268,4526
987654526,rustam shah,56103,16700,39403,4526
987654526,rustam shah,37623,37060,563,4526
987654526,rustam shah,59172,58290,882,4526
987654526,rustam shah,61658,39890,21768,4526
987654526,rustam shah,62307,42910,19397,4526
987654526,rustam shah,65574,50110,15464,4526
987654526,rustam shah,88542,83180,5362,4526
987654526,rustam shah,33883,29540,4343,4526
987654526,rustam shah,55916,16170,39746,4526
987654526,rustam shah,50086,26570,23516,4526
987654526,rustam shah,53221,50920,2301,4526
987654526,rustam shah,54530,47080,7450,4526
987654526,rustam shah,52011,48490,3521,4526
987654526,rustam shah,29307,13440,15867,4526
987654526,rustam shah,62956,34030,28926,4526
987654526,rustam shah,64232,26720,37512,4526
987654527,sukhdev,61207,20090,41117,4527
987654527,sukhdev,65574,52970,12604,4527
987654527,sukhdev,84604,67400,17204,4527
987654527,sukhdev,52913,47130,5783,4527
987654527,sukhdev,75067,56590,18477,4527
987654527,sukhdev,59403,27110,32293,4527
987654527,sukhdev,92964,41050,51914,4527
987654527,sukhdev,86562,24120,62442,4527
987654527,sukhdev,41792,24820,16972,4527
987654527,sukhdev,55630,46480,9150,4527
987654527,sukhdev,53639,42950,10689,4527
987654527,sukhdev,44894,41390,3504,4527
987654527,sukhdev,51516,50120,1396,4527
987654527,sukhdev,56697,41440,15257,4527
987654527,sukhdev,36160,30850,5310,4527
987654527,sukhdev,66542,17250,49292,4527
987654527,sukhdev,61900,49510,12390,4527
987654527,sukhdev,58358,21500,36858,4527
987654527,sukhdev,68401,38730,29671,4527
987654527,sukhdev,83911,64790,19121,4527
987654527,sukhdev,39416,15710,23706,4527
987654527,sukhdev,50812,17140,33672,4527
987654527,sukhdev,52022,21450,30572,4527
987654527,sukhdev,52132,51320,812,4527
987654528,b vikjay kumar,49019,47250,1769,4528
987654528,b vikjay kumar,58743,55390,3353,4528
987654528,b vikjay kumar,39141,15770,23371,4528
987654528,b vikjay kumar,61834,34200,27634,4528
987654528,b vikjay kumar,66300,16620,49680,4528
987654528,b vikjay kumar,68599,44940,23659,4528
987654528,b vikjay kumar,73494,49620,23874,4528
987654528,b vikjay kumar,84505,22080,62425,4528
987654528,b vikjay kumar,38085,36870,1215,4528
987654528,b vikjay kumar,55542,46250,9292,4528
987654528,b vikjay kumar,48029,30960,17069,4528
987654528,b vikjay kumar,53045,19490,33555,4528
987654528,b vikjay kumar,45917,34530,11387,4528
987654528,b vikjay kumar,55927,53450,2477,4528
987654528,b vikjay kumar,40197,38110,2087,4528
987654528,b vikjay kumar,61218,35010,26208,4528
987654528,b vikjay kumar,63880,23420,40460,4528
987654528,b vikjay kumar,70590,32170,38420,4528
987654528,b vikjay kumar,76596,48030,28566,4528
987654528,b vikjay kumar,90016,39230,50786,4528
987654528,b vikjay kumar,38052,24460,13592,4528
987654528,b vikjay kumar,48964,45470,3494,4528
987654528,b vikjay kumar,51835,45360,6475,4528
987654528,b vikjay kumar,48403,15420,32983,4528
987654529,monto shah,50317,25500,24817,4529
987654529,monto shah,55806,30110,25696,4529
987654529,monto shah,33014,16380,16634,4529
987654529,monto shah,61075,51410,9665,4529
987654529,monto shah,55839,35830,20009,4529
987654529,monto shah,69215,49990,19225,4529
987654529,monto shah,70689,40270,30419,4529
987654529,monto shah,81029,40030,40999,4529
987654529,monto shah,38448,29720,8728,4529
987654529,monto shah,72504,67390,5114,4529
987654529,monto shah,65035,32570,32465,4529
987654529,monto shah,58985,31050,27935,4529
987654529,monto shah,64078,59330,4748,4529
987654529,monto shah,76046,51700,24346,4529
987654529,monto shah,34653,32270,2383,4529
987654529,monto shah,51186,36650,14536,4529
987654529,monto shah,52660,46080,6580,4529
987654529,monto shah,46962,37810,9152,4529
987654529,monto shah,54090,46230,7860,4529
987654529,monto shah,47435,16070,31365,4529
987654529,monto shah,39295,13710,25585,4529
987654529,monto shah,61471,51910,9561,4529
987654529,monto shah,61911,29480,32431,4529
987654529,monto shah,58391,46730,11661,4529
987654530,gopal sharma,71195,61390,9805,4530
987654530,gopal sharma,75232,73840,1392,4530
987654530,gopal sharma,40373,18180,22193,4530
987654530,gopal sharma,51450,31610,19840,4530
987654530,gopal sharma,57445,14490,42955,4530
987654530,gopal sharma,47094,41850,5244,4530
987654530,gopal sharma,49294,25110,24184,4530
987654530,gopal sharma,61746,45900,15846,4530
987654530,gopal sharma,42122,16240,25882,4530
987654530,gopal sharma,68830,20050,48780,4530
987654530,gopal sharma,68819,35010,33809,4530
987654530,gopal sharma,68148,41460,26688,4530
987654530,gopal sharma,80303,50070,30233,4530
987654530,gopal sharma,138900,86730,52170,4530
987654530,gopal sharma,40681,23090,17591,4530
987654530,gopal sharma,59403,51130,8273,4530
987654530,gopal sharma,49591,49540,51,4530
987654530,gopal sharma,52616,35950,16666,4530
987654530,gopal sharma,52649,24930,27719,4530
987654530,gopal sharma,57753,54060,3693,4530
987654530,gopal sharma,41473,18070,23403,4530
987654530,gopal sharma,86111,43350,42761,4530
987654530,gopal sharma,73406,44040,29366,4530
987654530,gopal sharma,79863,31060,48803,4530
987654531,beeru,91930,48200,43730,4531
987654531,beeru,35302,31670,3632,4531
987654531,beeru,61108,48910,12198,4531
987654531,beeru,59337,36880,22457,4531
987654531,beeru,55971,51730,4241,4531
987654531,beeru,64144,57430,6714,4531
987654531,beeru,44454,14750,29704,4531
987654531,beeru,73340,59420,13920,4531
987654531,beeru,67741,48890,18851,4531
987654531,beeru,77058,31040,46018,4531
987654531,beeru,85946,65750,20196,4531
987654531,beeru,91094,43680,47414,4531
987654531,beeru,37370,17510,19860,4531
987654531,beeru,77080,51720,25360,4531
987654531,beeru,58644,37150,21494,4531
987654531,beeru,49558,38390,11168,4531
987654531,beeru,49635,16400,33235,4531
987654531,beeru,37271,31830,5441,4531
987654531,beeru,69754,55600,14154,4531
987654531,beeru,65233,20930,44303,4531
987654531,beeru,65431,22100,43331,4531
987654531,beeru,69270,57170,12100,4531
987654531,beeru,88773,61160,27613,4531
987654531,beeru,35951,26320,9631,4531
987654532,vipin,54156,30290,23866,4532
987654532,vipin,57445,46670,10775,4532
987654532,vipin,50416,46300,4116,4532
987654532,vipin,53958,33880,20078,4532
987654532,vipin,59117,58150,967,4532
987654532,vipin,39306,22530,16776,4532
987654532,vipin,72075,67660,4415,4532
987654532,vipin,67906,45810,22096,4532
987654532,vipin,69094,26410,42684,4532
987654532,vipin,75243,25220,50023,4532
987654532,vipin,86881,76980,9901,4532
987654532,vipin,41814,37010,4804,4532
987654532,vipin,89059,62140,26919,4532
987654532,vipin,89345,40790,48555,4532
987654532,vipin,73428,46340,27088,4532
987654532,vipin,85099,71960,13139,4532
987654532,vipin,34653,11870,22783,4532
987654532,vipin,58479,56790,1689,4532
987654532,vipin,52550,33730,18820,4532
987654532,vipin,51956,50070,1886,4532
987654532,vipin,60349,36530,23819,4532
987654532,vipin,43695,20290,23405,4532
987654532,vipin,85077,53320,31757,4532
987654532,vipin,69050,48660,20390,4532
987654533,manish garg,81887,45210,36677,4533
987654533,manish garg,93899,85430,8469,4533
987654533,manish garg,38613,33690,4923,4533
987654533,manish garg,58072,27710,30362,4533
987654533,manish garg,57456,42480,14976,4533
987654533,manish garg,57742,22450,35292,4533
987654533,manish garg,52275,19320,32955,4533
987654533,manish garg,61174,49940,11234,4533
987654533,manish garg,37271,20990,16281,4533
987654533,manish garg,69732,64020,5712,4533
987654533,manish garg,71976,68270,3706,4533
987654533,manish garg,63220,41830,21390,4533
987654533,manish garg,64936,33360,31576,4533
987654533,manish garg,119771,43770,76001,4533
987654533,manish garg,45576,14820,30756,4533
987654533,manish garg,54673,52560,2113,4533
987654533,manish garg,56312,32400,23912,4533
987654533,manish garg,53199,50840,2359,4533
987654533,manish garg,47820,33670,14150,4533
987654533,manish garg,65849,57210,8639,4533
987654533,manish garg,44938,14390,30548,4533
987654533,manish garg,63825,40310,23515,4533
987654533,manish garg,60184,24790,35394,4533
987654533,manish garg,68203,60060,8143,4533
987654534,guddu,78037,49620,28417,4534
987654534,guddu,87662,75800,11862,4534
987654534,guddu,41297,31770,9527,4534
987654534,guddu,53529,48310,5219,4534
987654534,guddu,56840,19560,37280,4534
987654534,guddu,51978,46840,5138,4534
987654534,guddu,53628,33240,20388,4534
987654534,guddu,62527,30630,31897,4534
987654534,guddu,33454,27020,6434,4534
987654534,guddu,68082,46570,21512,4534
987654534,guddu,68676,55060,13616,4534
987654534,guddu,74000,23140,50860,4534
987654534,guddu,83416,42180,41236,4534
987654534,guddu,58182,28230,29952,4534
987654534,guddu,45950,37930,8020,4534
987654534,guddu,60723,35740,24983,4534
987654534,guddu,48942,28030,20912,4534
987654534,guddu,48568,19330,29238,4534
987654534,guddu,50724,37640,13084,4534
987654534,guddu,52825,18450,34375,4534
987654534,guddu,37414,19430,17984,4534
987654534,guddu,66828,41690,25138,4534
987654534,guddu,63880,39680,24200,4534
987654534,guddu,71701,64160,7541,4534
987654535,jatin,71217,25500,45717,4535
987654535,jatin,87486,32280,55206,4535
987654535,jatin,38789,17990,20799,4535
987654535,jatin,58193,34160,24033,4535
987654535,jatin,52011,35360,16651,4535
987654535,jatin,51670,44870,6800,4535
987654535,jatin,52924,27720,25204,4535
987654535,jatin,56719,25610,31109,4535
987654535,jatin,36655,29650,7005,4535
987654535,jatin,63990,46150,17840,4535
987654535,jatin,65497,53050,12447,4535
987654535,jatin,64342,46650,17692,4535
987654535,jatin,75232,73390,1842,4535
987654535,jatin,104723,57040,47683,4535
987654535,jatin,36017,23120,12897,4535
987654535,jatin,69193,21570,47623,4535
987654535,jatin,46841,43000,3841,4535
987654535,jatin,50658,43940,6718,4535
987654535,jatin,54233,28650,25583,4535
987654535,jatin,55443,44900,10543,4535
987654535,jatin,37898,14990,22908,4535
987654535,jatin,69754,22370,47384,4535
987654535,jatin,64551,35260,29291,4535
987654535,jatin,69039,25940,43099,4535
987654536,amit kumar,70216,63260,6956,4536
987654536,amit kumar,83933,66960,16973,4536
987654536,amit kumar,36589,11760,24829,4536
987654536,amit kumar,50526,21390,29136,4536
987654536,amit kumar,44674,13660,31014,4536
987654536,amit kumar,50779,28300,22479,4536
987654536,amit kumar,53529,33850,19679,4536
987654536,amit kumar,56433,25520,30913,4536
987654536,amit kumar,36985,18730,18255,4536
987654536,amit kumar,69336,52110,17226,4536
987654536,amit kumar,58611,18930,39681,4536
987654536,amit kumar,71855,33480,38375,4536
987654536,amit kumar,81590,80650,940,4536
987654536,amit kumar,94405,89330,5075,4536
987654536,amit kumar,35434,35370,64,4536
987654536,amit kumar,61185,35560,25625,4536
987654536,amit kumar,54200,33340,20860,4536
987654536,amit kumar,46610,32240,14370,4536
987654536,amit kumar,93140,53900,39240,4536
987654536,amit kumar,38745,33730,5015,4536
987654536,amit kumar,65134,51130,14004,4536
987654536,amit kumar,38613,31090,7523,4536
987654536,amit kumar,107792,52090,55702,4536
987654536,amit kumar,58314,41810,16504,4536
987654537,amit kumar,91325,72190,19135,4537
987654537,amit kumar,82899,37390,45509,4537
987654537,amit kumar,93514,58060,35454,4537
987654537,amit kumar,94460,30710,63750,4537
987654537,amit kumar,115800,109220,6580,4537
987654537,amit kumar,41946,11880,30066,4537
987654537,amit kumar,64375,42370,22005,4537
987654537,amit kumar,56950,37250,19700,4537
987654537,amit kumar,62219,21630,40589,4537
987654537,amit kumar,57918,25510,32408,4537
987654537,amit kumar,65266,34660,30606,4537
987654537,amit kumar,44300,39730,4570,4537
987654537,amit kumar,78642,38990,39652,4537
987654537,amit kumar,78389,76770,1619,4537
987654537,amit kumar,76376,59850,16526,4537
987654537,amit kumar,91578,41910,49668,4537
987654537,amit kumar,94812,89860,4952,4537
987654537,amit kumar,45004,21820,23184,4537
987654537,amit kumar,68654,52100,16554,4537
987654537,amit kumar,54618,48150,6468,4537
987654537,amit kumar,60294,27440,32854,4537
987654537,amit kumar,50141,17950,32191,4537
987654537,amit kumar,57049,37840,19209,4537
987654537,amit kumar,40351,34340,6011,4537
987654538,shadab,65101,39130,25971,4538
987654538,shadab,64386,46790,17596,4538
987654538,shadab,71107,55200,15907,4538
987654538,shadab,74781,46410,28371,4538
987654538,shadab,87937,85990,1947,4538
987654538,shadab,39350,18640,20710,4538
987654538,shadab,53628,44880,8748,4538
987654538,shadab,56103,32310,23793,4538
987654538,shadab,47413,21250,26163,4538
987654538,shadab,51340,21270,30070,4538
987654538,shadab,53606,45500,8106,4538
987654538,shadab,44102,28110,15992,4538
987654538,shadab,75419,69560,5859,4538
987654538,shadab,60019,50560,9459,4538
987654538,shadab,71327,48100,23227,4538
987654538,shadab,81810,20870,60940,4538
987654538,shadab,78400,20840,57560,4538
987654538,shadab,52297,37770,14527,4538
987654538,shadab,64364,56210,8154,4538
987654538,shadab,52451,40730,11721,4538
987654538,shadab,51659,27310,24349,4538
987654538,shadab,49294,18510,30784,4538
987654538,shadab,30583,19120,11463,4538
987654538,shadab,57533,22840,34693,4538
987654539,rakesh,61262,42800,18462,4539
987654539,rakesh,56939,19770,37169,4539
987654539,rakesh,62956,25310,37646,4539
987654539,rakesh,75287,27800,47487,4539
987654539,rakesh,36633,30270,6363,4539
987654539,rakesh,53056,40340,12716,4539
987654539,rakesh,44058,42860,1198,4539
987654539,rakesh,49932,19050,30882,4539
987654539,rakesh,53628,34430,19198,4539
987654539,rakesh,58270,19770,38500,4539
987654539,rakesh,39702,10120,29582,4539
987654539,rakesh,60580,18550,42030,4539
987654539,rakesh,65761,59070,6691,4539
987654539,rakesh,68412,56310,12102,4539
987654539,rakesh,79016,59310,19706,4539
987654539,rakesh,79544,54810,24734,4539
987654539,rakesh,34334,23020,11314,4539
987654539,rakesh,68577,29650,38927,4539
987654539,rakesh,59480,37760,21720,4539
987654539,rakesh,50482,18780,31702,4539
987654539,rakesh,73736,63400,10336,4539
987654539,rakesh,34521,33970,551,4539
987654539,rakesh,70326,54780,15546,4539
987654539,rakesh,61988,35740,26248,4539
987654540,guddu,60778,59300,1478,4540
987654540,guddu,63143,52480,10663,4540
987654540,guddu,82613,55500,27113,4540
987654540,guddu,30935,19070,11865,4540
987654540,guddu,45631,28990,16641,4540
987654540,guddu,47996,38660,9336,4540
987654540,guddu,44520,14530,29990,4540
987654540,guddu,46599,24390,22209,4540
987654540,guddu,52814,43230,9584,4540
987654540,guddu,33509,13870,19639,4540
987654540,guddu,63561,31510,32051,4540
987654540,guddu,66553,56990,9563,4540
987654540,guddu,64221,38840,25381,4540
987654540,guddu,59667,41780,17887,4540
987654540,guddu,90170,54570,35600,4540
987654540,guddu,31001,13720,17281,4540
987654540,guddu,48898,18280,30618,4540
987654540,guddu,46698,31680,15018,4540
987654540,guddu,44894,28840,16054,4540
987654540,guddu,49635,42680,6955,4540
987654540,guddu,55190,30120,25070,4540
987654540,guddu,38954,29450,9504,4540
987654540,guddu,68181,56060,12121,4540
987654540,guddu,61339,52240,9099,4540
987654541,abhishek,52143,48930,3213,4541
987654541,abhishek,64826,58990,5836,4541
987654541,abhishek,82712,75120,7592,4541
987654541,abhishek,31100,14180,16920,4541
987654541,abhishek,45961,16590,29371,4541
987654541,abhishek,42980,12800,30180,4541
987654541,abhishek,41440,27020,14420,4541
987654541,abhishek,46302,35520,10782,4541
987654541,abhishek,49767,43010,6757,4541
987654541,abhishek,33014,26150,6864,4541
987654541,abhishek,59656,21600,38056,4541
987654541,abhishek,56279,42530,13749,4541
987654541,abhishek,61603,47630,13973,4541
987654541,abhishek,69644,22580,47064,4541
987654541,abhishek,91039,78640,12399,4541
987654541,abhishek,31947,28390,3557,4541
987654541,abhishek,50493,46020,4473,4541
987654541,abhishek,48535,24580,23955,4541
987654541,abhishek,48590,46390,2200,4541
987654541,abhishek,53199,15750,37449,4541
987654541,abhishek,55157,41560,13597,4541
987654541,abhishek,31023,14550,16473,4541
987654541,abhishek,59216,53810,5406,4541
987654541,abhishek,62758,16120,46638,4541
987654542,gulfam,71547,23000,48547,4542
987654542,gulfam,72163,46900,25263,4542
987654542,gulfam,88663,45910,42753,4542
987654542,gulfam,32662,15910,16752,4542
987654542,gulfam,48931,35990,12941,4542
987654542,gulfam,49679,41340,8339,4542
987654542,gulfam,46654,21070,25584,4542
987654542,gulfam,45081,35630,9451,4542
987654542,gulfam,54090,33270,20820,4542
987654542,gulfam,39757,25050,14707,4542
987654542,gulfam,74374,70010,4364,4542
987654542,gulfam,76574,30630,45944,4542
987654542,gulfam,73340,39970,33370,4542
987654542,gulfam,81909,56370,25539,4542
987654542,gulfam,99300,34470,64830,4542
987654542,gulfam,39526,12350,27176,4542
987654542,gulfam,54343,48830,5513,4542
987654542,gulfam,54662,33110,21552,4542
987654542,gulfam,55498,28940,26558,4542
987654542,gulfam,54046,16150,37896,4542
987654542,gulfam,57214,49550,7664,4542
987654542,gulfam,37271,29720,7551,4542
987654542,gulfam,71349,25360,45989,4542
987654542,gulfam,66377,37190,29187,4542
987654543,phoolwati ,61867,22310,39557,4543
987654543,phoolwati ,71195,19420,51775,4543
987654543,phoolwati ,75353,28090,47263,4543
987654543,phoolwati ,44476,15650,28826,4543
987654543,phoolwati ,55289,53560,1729,4543
987654543,phoolwati ,52913,34170,18743,4543
987654543,phoolwati ,44355,22190,22165,4543
987654543,phoolwati ,49679,41300,8379,4543
987654543,phoolwati ,57566,15670,41896,4543
987654543,phoolwati ,41616,34880,6736,4543
987654543,phoolwati ,68302,31180,37122,4543
987654543,phoolwati ,60800,42340,18460,4543
987654543,phoolwati ,69996,41270,28726,4543
987654543,phoolwati ,65827,50560,15267,4543
987654543,phoolwati ,97914,97580,334,4543
987654543,phoolwati ,37304,35110,2194,4543
987654543,phoolwati ,62340,19150,43190,4543
987654543,phoolwati ,45752,29590,16162,4543
987654543,phoolwati ,51626,38970,12656,4543
987654543,phoolwati ,53507,35830,17677,4543
987654543,phoolwati ,63319,27320,35999,4543
987654543,phoolwati ,33498,27730,5768,4543
987654543,phoolwati ,67873,49630,18243,4543
987654543,phoolwati ,63847,21790,42057,4543
987654544,mohit maan,70711,59450,11261,4544
987654544,mohit maan,72460,58920,13540,4544
987654544,mohit maan,88146,45370,42776,4544
987654544,mohit maan,37623,16630,20993,4544
987654544,mohit maan,89422,41570,47852,4544
987654544,mohit maan,80358,46120,34238,4544
987654544,mohit maan,66069,61980,4089,4544
987654544,mohit maan,87442,60830,26612,4544
987654544,mohit maan,38866,11300,27566,4544
987654544,mohit maan,57445,38560,18885,4544
987654544,mohit maan,47479,17860,29619,4544
987654544,mohit maan,49921,44850,5071,4544
987654544,mohit maan,62890,21950,40940,4544
987654544,mohit maan,35654,28710,6944,4544
987654544,mohit maan,71349,30010,41339,4544
987654544,mohit maan,65849,39920,25929,4544
987654544,mohit maan,65431,60170,5261,4544
987654544,mohit maan,72878,25380,47498,4544
987654544,mohit maan,75727,67860,7867,4544
987654544,mohit maan,33872,11030,22842,4544
987654544,mohit maan,69534,40930,28604,4544
987654544,mohit maan,63154,22830,40324,4544
987654544,mohit maan,52033,34060,17973,4544
987654544,mohit maan,60734,24290,36444,4544
987654545,veer bhan singh,38008,29040,8968,4545
987654545,veer bhan singh,79797,65370,14427,4545
987654545,veer bhan singh,84439,42260,42179,4545
987654545,veer bhan singh,81073,68180,12893,4545
987654545,veer bhan singh,86683,48210,38473,4545
987654545,veer bhan singh,40274,29490,10784,4545
987654545,veer bhan singh,56213,43720,12493,4545
987654545,veer bhan singh,58501,16540,41961,4545
987654545,veer bhan singh,56939,51850,5089,4545
987654545,veer bhan singh,68896,35450,33446,4545
987654545,veer bhan singh,91413,54000,37413,4545
987654545,veer bhan singh,35302,18260,17042,4545
987654545,veer bhan singh,49657,43410,6247,4545
987654545,veer bhan singh,47402,25970,21432,4545
987654545,veer bhan singh,44487,42810,1677,4545
987654545,veer bhan singh,49360,26460,22900,4545
987654545,veer bhan singh,58732,48470,10262,4545
987654545,veer bhan singh,32156,16010,16146,4545
987654545,veer bhan singh,64320,33310,31010,4545
987654545,veer bhan singh,62076,37390,24686,4545
987654545,veer bhan singh,61999,41090,20909,4545
987654545,veer bhan singh,72449,63640,8809,4545
987654545,veer bhan singh,85484,70830,14654,4545
987654545,veer bhan singh,37436,28100,9336,4545
987654546,dinesh kumar,57819,17130,40689,4546
987654546,dinesh kumar,56609,35060,21549,4546
987654546,dinesh kumar,49855,36950,12905,4546
987654546,dinesh kumar,54354,41810,12544,4546
987654546,dinesh kumar,63506,45560,17946,4546
987654546,dinesh kumar,90566,64550,26016,4546
987654546,dinesh kumar,72746,36750,35996,4546
987654546,dinesh kumar,80611,73650,6961,4546
987654546,dinesh kumar,79071,27970,51101,4546
987654546,dinesh kumar,36369,15450,20919,4546
987654546,dinesh kumar,74935,45540,29395,4546
987654546,dinesh kumar,68269,50070,18199,4546
987654546,dinesh kumar,60360,55860,4500,4546
987654546,dinesh kumar,74847,71980,2867,4546
987654546,dinesh kumar,89664,52490,37174,4546
987654546,dinesh kumar,35115,33630,1485,4546
987654546,dinesh kumar,56983,51910,5073,4546
987654546,dinesh kumar,50636,49600,1036,4546
987654546,dinesh kumar,51373,15850,35523,4546
987654546,dinesh kumar,46918,26640,20278,4546
987654546,dinesh kumar,62274,57820,4454,4546
987654546,dinesh kumar,35390,15810,19580,4546
987654546,dinesh kumar,66168,48090,18078,4546
987654546,dinesh kumar,67455,52740,14715,4546
987654547,amarjeet,65376,19300,46076,4547
987654547,amarjeet,72174,36880,35294,4547
987654547,amarjeet,92887,85110,7777,4547
987654547,amarjeet,37887,37650,237,4547
987654547,amarjeet,57258,41940,15318,4547
987654547,amarjeet,59359,51540,7819,4547
987654547,amarjeet,49580,32560,17020,4547
987654547,amarjeet,51956,34930,17026,4547
987654547,amarjeet,52385,14200,38185,4547
987654547,amarjeet,31067,23920,7147,4547
987654547,amarjeet,66454,55930,10524,4547
987654547,amarjeet,64166,41180,22986,4547
987654547,amarjeet,60844,24230,36614,4547
987654547,amarjeet,65640,38490,27150,4547
987654547,amarjeet,90280,22830,67450,4547
987654547,amarjeet,30308,28950,1358,4547
987654547,amarjeet,57148,43570,13578,4547
987654547,amarjeet,59854,41350,18504,4547
987654547,amarjeet,53815,44160,9655,4547
987654547,amarjeet,60019,47130,12889,4547
987654547,amarjeet,36831,20580,16251,4547
987654547,amarjeet,36798,15750,21048,4547
987654547,amarjeet,69666,17920,51746,4547
987654547,amarjeet,67147,47710,19437,4547
987654548,satyadev,65387,40780,24607,4548
987654548,satyadev,80281,44170,36111,4548
987654548,satyadev,84758,44090,40668,4548
987654548,satyadev,35192,32450,2742,4548
987654548,satyadev,66058,57490,8568,4548
987654548,satyadev,59073,40360,18713,4548
987654548,satyadev,54255,39700,14555,4548
987654548,satyadev,46082,31480,14602,4548
987654548,satyadev,58138,33190,24948,4548
987654548,satyadev,36171,18710,17461,4548
987654548,satyadev,63451,20150,43301,4548
987654548,satyadev,66113,41080,25033,4548
987654548,satyadev,62626,22650,39976,4548
987654548,satyadev,73483,59190,14293,4548
987654548,satyadev,75606,42650,32956,4548
987654548,satyadev,35720,35680,40,4548
987654548,satyadev,56741,16440,40301,4548
987654548,satyadev,51087,24110,26977,4548
987654548,satyadev,50746,26350,24396,4548
987654548,satyadev,48183,31880,16303,4548
987654548,satyadev,49800,13380,36420,4548
987654548,satyadev,33300,26500,6800,4548
987654548,satyadev,67829,32080,35749,4548
987654548,satyadev,66586,53900,12686,4548
987654549,mohd. mukhtaar,59381,30380,29001,4549
987654549,mohd. mukhtaar,76200,27760,48440,4549
987654549,mohd. mukhtaar,85748,61700,24048,4549
987654549,mohd. mukhtaar,27789,16330,11459,4549
987654549,mohd. mukhtaar,52154,18070,34084,4549
987654549,mohd. mukhtaar,45939,25090,20849,4549
987654549,mohd. mukhtaar,57863,29420,28443,4549
987654549,mohd. mukhtaar,112621,64470,48151,4549
987654549,mohd. mukhtaar,112566,84340,28226,4549
987654549,mohd. mukhtaar,104261,77860,26401,4549
987654549,mohd. mukhtaar,106725,38230,68495,4549
987654549,mohd. mukhtaar,112940,106080,6860,4549
987654549,mohd. mukhtaar,67235,42200,25035,4549
987654549,mohd. mukhtaar,85671,25240,60431,4549
987654549,mohd. mukhtaar,86595,77230,9365,4549
987654549,mohd. mukhtaar,74649,69420,5229,4549
987654549,mohd. mukhtaar,80094,33460,46634,4549
987654549,mohd. mukhtaar,84032,68670,15362,4549
987654549,mohd. mukhtaar,58248,51310,6938,4549
987654549,mohd. mukhtaar,83735,26880,56855,4549
987654549,mohd. mukhtaar,87574,43370,44204,4549
987654549,mohd. mukhtaar,111169,98760,12409,4549
987654549,mohd. mukhtaar,109926,34510,75416,4549
987654549,mohd. mukhtaar,131332,85810,45522,4549
987654550,rishi,59634,21190,38444,4550
987654550,rishi,85528,59560,25968,4550
987654550,rishi,75617,44800,30817,4550
987654550,rishi,90544,84540,6004,4550
987654550,rishi,76992,24880,52112,4550
987654550,rishi,88729,45220,43509,4550
987654550,rishi,55674,28280,27394,4550
987654550,rishi,104063,77320,26743,4550
987654550,rishi,92557,43780,48777,4550
987654550,rishi,115899,71550,44349,4550
987654550,rishi,122400,48770,73630,4550
987654550,rishi,138834,132510,6324,4550
987654550,rishi,50075,27060,23015,4550
987654550,rishi,76211,62850,13361,4550
987654550,rishi,75353,30820,44533,4550
987654550,rishi,76189,35660,40529,4550
987654550,rishi,81392,44550,36842,4550
987654550,rishi,86430,53340,33090,4550
987654550,rishi,62736,53480,9256,4550
987654550,rishi,94460,68440,26020,4550
987654550,rishi,77366,52780,24586,4550
987654550,rishi,109222,64020,45202,4550
987654550,rishi,113743,113370,373,4550
987654550,rishi,120717,57080,63637,4550
987654551,esrail khan,61295,24340,36955,4551
987654551,esrail khan,75639,23520,52119,4551
987654551,esrail khan,83801,69120,14681,4551
987654551,esrail khan,84010,48750,35260,4551
987654551,esrail khan,79753,58660,21093,4551
987654551,esrail khan,86089,66380,19709,4551
987654551,esrail khan,56862,44920,11942,4551
987654551,esrail khan,110696,78310,32386,4551
987654551,esrail khan,105108,40960,64148,4551
987654551,esrail khan,112104,36010,76094,4551
987654551,esrail khan,129110,89050,40060,4551
987654551,esrail khan,61647,41010,20637,4551
987654551,esrail khan,87684,24790,62894,4551
987654551,esrail khan,82778,42940,39838,4551
987654551,esrail khan,76123,58700,17423,4551
987654551,esrail khan,89301,40910,48391,4551
987654551,esrail khan,66256,36630,29626,4551
987654551,esrail khan,100356,29420,70936,4551
987654551,esrail khan,96418,53000,43418,4551
987654551,esrail khan,100972,98200,2772,4551
987654551,esrail khan,100246,51850,48396,4551
987654551,esrail khan,128109,57310,70799,4551
987654551,esrail khan,63836,43990,19846,4551
987654551,esrail khan,101115,61550,39565,4551
987654552,suresh kumar,97111,57360,39751,4552
987654552,suresh kumar,88113,76590,11523,4552
987654552,suresh kumar,83592,27380,56212,4552
987654552,suresh kumar,63341,19510,43831,4552
987654552,suresh kumar,100246,80490,19756,4552
987654552,suresh kumar,97815,94490,3325,4552
987654552,suresh kumar,101797,37990,63807,4552
987654552,suresh kumar,104228,34840,69388,4552
987654552,suresh kumar,130738,79270,51468,4552
987654552,suresh kumar,79049,29870,49179,4552
987654552,suresh kumar,111345,32920,78425,4552
987654552,suresh kumar,110289,96650,13639,4552
987654552,suresh kumar,100906,92670,8236,4552
987654552,suresh kumar,118847,51130,67717,4552
987654552,suresh kumar,56477,41190,15287,4552
987654552,suresh kumar,74253,23140,51113,4552
987654552,suresh kumar,69820,58870,10950,4552
987654552,suresh kumar,76409,26500,49909,4552
987654552,suresh kumar,74451,59710,14741,4552
987654552,suresh kumar,86012,39350,46662,4552
987654552,suresh kumar,62274,30650,31624,4552
987654552,suresh kumar,99212,68560,30652,4552
987654552,suresh kumar,96253,79570,16683,4552
987654552,suresh kumar,98585,73940,24645,4552
987654553,pankaj chand,103799,30570,73229,4553
987654553,pankaj chand,115701,78440,37261,4553
987654553,pankaj chand,56411,32510,23901,4553
987654553,pankaj chand,81161,32740,48421,4553
987654553,pankaj chand,74264,31420,42844,4553
987654553,pankaj chand,81876,79450,2426,4553
987654553,pankaj chand,92557,33530,59027,4553
987654553,pankaj chand,81788,59570,22218,4553
987654553,pankaj chand,125612,58040,67572,4553
987654553,pankaj chand,132718,132590,128,4553
987654553,pankaj chand,116108,52520,63588,4553
987654553,pankaj chand,136227,118110,18117,4553
987654553,pankaj chand,66135,36040,30095,4553
987654553,pankaj chand,85011,49200,35811,4553
987654553,pankaj chand,82558,37530,45028,4553
987654553,pankaj chand,76354,19760,56594,4553
987654553,pankaj chand,79445,67540,11905,4553
987654553,pankaj chand,83042,24290,58752,4553
987654553,pankaj chand,57313,56920,393,4553
987654553,pankaj chand,86430,64430,22000,4553
987654553,pankaj chand,96539,38480,58059,4553
987654553,pankaj chand,90830,89730,1100,4553
987654553,pankaj chand,103425,37580,65845,4553
987654553,pankaj chand,125997,46390,79607,4553
987654554,ajay narayan,59480,58410,1070,4554
987654554,ajay narayan,88223,33740,54483,4554
987654554,ajay narayan,75837,34090,41747,4554
987654554,ajay narayan,84164,31480,52684,4554
987654554,ajay narayan,79753,36680,43073,4554
987654554,ajay narayan,89191,82620,6571,4554
987654554,ajay narayan,56653,32630,24023,4554
987654554,ajay narayan,93712,90040,3672,4554
987654554,ajay narayan,92678,48990,43688,4554
987654554,ajay narayan,98068,82900,15168,4554
987654554,ajay narayan,117263,89710,27553,4554
987654554,ajay narayan,126096,89120,36976,4554
987654554,ajay narayan,63077,16630,46447,4554
987654554,ajay narayan,78323,49000,29323,4554
987654554,ajay narayan,81392,80370,1022,4554
987654554,ajay narayan,76310,49770,26540,4554
987654554,ajay narayan,77663,44710,32953,4554
987654554,ajay narayan,69952,33370,36582,4554
987654554,ajay narayan,51340,21650,29690,4554
987654554,ajay narayan,88718,33920,54798,4554
987654554,ajay narayan,82481,65700,16781,4554
987654554,ajay narayan,85759,41640,44119,4554
987654554,ajay narayan,85297,31310,53987,4554
987654554,ajay narayan,124281,81660,42621,4554
987654555,mohit @ himanshu,66245,22750,43495,4555
987654555,mohit @ himanshu,79445,33720,45725,4555
987654555,mohit @ himanshu,71866,49530,22336,4555
987654555,mohit @ himanshu,77234,72880,4354,4555
987654555,mohit @ himanshu,77223,41670,35553,4555
987654555,mohit @ himanshu,84758,22110,62648,4555
987654555,mohit @ himanshu,69292,34500,34792,4555
987654555,mohit @ himanshu,94405,31310,63095,4555
987654555,mohit @ himanshu,97837,90770,7067,4555
987654555,mohit @ himanshu,96649,86860,9789,4555
987654555,mohit @ himanshu,114007,90070,23937,4555
987654555,mohit @ himanshu,110179,100340,9839,4555
987654555,mohit @ himanshu,64078,17660,46418,4555
987654555,mohit @ himanshu,105086,64790,40296,4555
987654555,mohit @ himanshu,93041,81810,11231,4555
987654555,mohit @ himanshu,99058,72230,26828,4555
987654555,mohit @ himanshu,100290,58250,42040,4555
987654555,mohit @ himanshu,102534,38030,64504,4555
987654555,mohit @ himanshu,57148,47460,9688,4555
987654555,mohit @ himanshu,67862,42240,25622,4555
987654555,mohit @ himanshu,68181,64050,4131,4555
987654555,mohit @ himanshu,77058,60030,17028,4555
987654555,mohit @ himanshu,64144,41090,23054,4555
987654555,mohit @ himanshu,79225,49680,29545,4555
987654556,sumit,56961,21140,35821,4556
987654556,sumit,91798,83200,8598,4556
987654556,sumit,95252,57460,37792,4556
987654556,sumit,86540,55550,30990,4556
987654556,sumit,103832,73230,30602,4556
987654556,sumit,115063,65140,49923,4556
987654556,sumit,58809,29870,28939,4556
987654556,sumit,92964,67630,25334,4556
987654556,sumit,97397,77100,20297,4556
987654556,sumit,117626,51070,66556,4556
987654556,sumit,135721,34560,101161,4556
987654556,sumit,57093,20480,36613,4556
987654556,sumit,70359,22090,48269,4556
987654556,sumit,52000,38520,13480,4556
987654556,sumit,85462,31650,53812,4556
987654556,sumit,85693,44570,41123,4556
987654556,sumit,58820,22830,35990,4556
987654556,sumit,81183,43410,37773,4556
987654556,sumit,140407,123570,16837,4556
987654556,sumit,147172,96500,50672,4556
987654556,sumit,95450,47510,47940,4556
987654556,sumit,125227,114490,10737,4556
987654556,sumit,131816,50790,81026,4556
987654556,sumit,130276,49330,80946,4556
987654557,saddam,149196,66220,82976,4557
987654557,saddam,150582,144570,6012,4557
987654557,saddam,78246,64480,13766,4557
987654557,saddam,95362,24640,70722,4557
987654557,saddam,84978,48130,36848,4557
987654557,saddam,83405,70130,13275,4557
987654557,saddam,95483,64740,30743,4557
987654557,saddam,93448,58760,34688,4557
987654557,saddam,76970,28970,48000,4557
987654557,saddam,143399,126130,17269,4557
987654557,saddam,116922,54120,62802,4557
987654557,saddam,121421,34540,86881,4557
987654557,saddam,123467,97150,26317,4557
987654557,saddam,139120,124980,14140,4557
987654557,saddam,88707,83820,4887,4557
987654557,saddam,121135,51740,69395,4557
987654557,saddam,110542,81320,29222,4557
987654557,saddam,101786,52470,49316,4557
987654557,saddam,109332,100390,8942,4557
987654557,saddam,108485,75330,33155,4557
987654557,saddam,57918,55370,2548,4557
987654557,saddam,82129,76900,5229,4557
987654557,saddam,77718,71250,6468,4557
987654557,saddam,77047,71170,5877,4557
987654558,nikhleshwar bhagat,76068,21530,54538,4558
987654558,nikhleshwar bhagat,84197,37070,47127,4558
987654558,nikhleshwar bhagat,69875,32030,37845,4558
987654558,nikhleshwar bhagat,99465,45080,54385,4558
987654558,nikhleshwar bhagat,92084,44930,47154,4558
987654558,nikhleshwar bhagat,86848,43660,43188,4558
987654558,nikhleshwar bhagat,106527,42740,63787,4558
987654558,nikhleshwar bhagat,105889,83570,22319,4558
987654558,nikhleshwar bhagat,72449,55240,17209,4558
987654558,nikhleshwar bhagat,102061,68940,33121,4558
987654558,nikhleshwar bhagat,103073,77010,26063,4558
987654558,nikhleshwar bhagat,87596,57240,30356,4558
987654558,nikhleshwar bhagat,124699,93420,31279,4558
987654558,nikhleshwar bhagat,136777,118450,18327,4558
987654558,nikhleshwar bhagat,98739,73570,25169,4558
987654558,nikhleshwar bhagat,78422,75310,3112,4558
987654558,nikhleshwar bhagat,77201,49320,27881,4558
987654558,nikhleshwar bhagat,81711,61950,19761,4558
987654558,nikhleshwar bhagat,88806,38140,50666,4558
987654558,nikhleshwar bhagat,55509,24420,31089,4558
987654558,nikhleshwar bhagat,91798,42600,49198,4558
987654558,nikhleshwar bhagat,79918,58420,21498,4558
987654558,nikhleshwar bhagat,84505,28880,55625,4558
987654558,nikhleshwar bhagat,102028,80710,21318,4558
987654559,jai singh,112214,81100,31114,4559
987654559,jai singh,64892,32940,31952,4559
987654559,jai singh,74836,70160,4676,4559
987654559,jai singh,72031,58440,13591,4559
987654559,jai singh,71184,38960,32224,4559
987654559,jai singh,73406,47170,26236,4559
987654559,jai singh,80358,42260,38098,4559
987654559,jai singh,56565,19680,36885,4559
987654559,jai singh,87530,30620,56910,4559
987654559,jai singh,91974,88230,3744,4559
987654559,jai singh,95230,47800,47430,4559
987654559,jai singh,91325,84680,6645,4559
987654559,jai singh,108650,62720,45930,4559
987654559,jai singh,65222,58440,6782,4559
987654559,jai singh,98200,30550,67650,4559
987654559,jai singh,104118,89240,14878,4559
987654559,jai singh,113226,101790,11436,4559
987654559,jai singh,105889,96390,9499,4559
987654559,jai singh,48315,39170,9145,4559
987654559,jai singh,69050,46010,23040,4559
987654559,jai singh,67235,53810,13425,4559
987654559,jai singh,68192,61180,7012,4559
987654559,jai singh,68236,48520,19716,4559
987654559,jai singh,80127,54790,25337,4559
987654560,deepak,55707,23060,32647,4560
987654560,deepak,86496,76280,10216,4560
987654560,deepak,87211,29710,57501,4560
987654560,deepak,87068,61210,25858,4560
987654560,deepak,102820,93430,9390,4560
987654560,deepak,117549,93500,24049,4560
987654560,deepak,55036,52870,2166,4560
987654560,deepak,60855,24180,36675,4560
987654560,deepak,70964,61650,9314,4560
987654560,deepak,75518,37340,38178,4560
987654560,deepak,78125,44630,33495,4560
987654560,deepak,70722,29920,40802,4560
987654560,deepak,54486,53770,716,4560
987654560,deepak,81370,51270,30100,4560
987654560,deepak,83141,40390,42751,4560
987654560,deepak,82492,74740,7752,4560
987654560,deepak,87970,62660,25310,4560
987654560,deepak,106516,105470,1046,4560
987654560,deepak,53221,26020,27201,4560
987654560,deepak,70711,64730,5981,4560
987654560,deepak,68445,45590,22855,4560
987654560,deepak,60382,53910,6472,4560
987654560,deepak,58259,37400,20859,4560
987654560,deepak,67158,66830,328,4560
987654561,sunil kumar,45994,32590,13404,4561
987654561,sunil kumar,81524,81100,424,4561
987654561,sunil kumar,81777,70940,10837,4561
987654561,sunil kumar,87112,32240,54872,4561
987654561,sunil kumar,90533,72480,18053,4561
987654561,sunil kumar,104657,63410,41247,4561
987654561,sunil kumar,53507,38540,14967,4561
987654561,sunil kumar,67752,26970,40782,4561
987654561,sunil kumar,70359,32090,38269,4561
987654561,sunil kumar,70711,46450,24261,4561
987654561,sunil kumar,72691,31010,41681,4561
987654561,sunil kumar,80083,20110,59973,4561
987654561,sunil kumar,49118,37170,11948,4561
987654561,sunil kumar,81711,77430,4281,4561
987654561,sunil kumar,82195,51720,30475,4561
987654561,sunil kumar,100499,90360,10139,4561
987654561,sunil kumar,99861,93510,6351,4561
987654561,sunil kumar,118814,34490,84324,4561
987654561,sunil kumar,62989,47580,15409,4561
987654561,sunil kumar,100202,60240,39962,4561
987654561,sunil kumar,117098,106450,10648,4561
987654561,sunil kumar,118044,59680,58364,4561
987654561,sunil kumar,116207,53840,62367,4561
987654561,sunil kumar,120904,114280,6624,4561
987654562,ram kishan,59205,23780,35425,4562
987654562,ram kishan,79907,66520,13387,4562
987654562,ram kishan,77553,62300,15253,4562
987654562,ram kishan,80842,69340,11502,4562
987654562,ram kishan,75419,53420,21999,4562
987654562,ram kishan,84450,22730,61720,4562
987654562,ram kishan,58061,57860,201,4562
987654562,ram kishan,85550,57870,27680,4562
987654562,ram kishan,89136,67770,21366,4562
987654562,ram kishan,99487,70990,28497,4562
987654562,ram kishan,111444,36870,74574,4562
987654562,ram kishan,115415,68790,46625,4562
987654562,ram kishan,58721,40400,18321,4562
987654562,ram kishan,77212,48070,29142,4562
987654562,ram kishan,78994,66190,12804,4562
987654562,ram kishan,73450,44760,28690,4562
987654562,ram kishan,66432,18050,48382,4562
987654562,ram kishan,80556,66910,13646,4562
987654562,ram kishan,62065,32460,29605,4562
987654562,ram kishan,84164,67050,17114,4562
987654562,ram kishan,97826,34970,62856,4562
987654562,ram kishan,97507,65410,32097,4562
987654562,ram kishan,108639,93120,15519,4562
987654562,ram kishan,122873,84190,38683,4562
987654563,arun,54893,35610,19283,4563
987654563,arun,82349,27550,54799,4563
987654563,arun,68324,58250,10074,4563
987654563,arun,76750,21250,55500,4563
987654563,arun,81348,26780,54568,4563
987654563,arun,89576,28910,60666,4563
987654563,arun,51978,47800,4178,4563
987654563,arun,103942,78360,25582,4563
987654563,arun,100598,37610,62988,4563
987654563,arun,97331,96850,481,4563
987654563,arun,111807,34360,77447,4563
987654563,arun,57214,25710,31504,4563
987654563,arun,71756,68550,3206,4563
987654563,arun,76475,21740,54735,4563
987654563,arun,80094,36070,44024,4563
987654563,arun,83229,51250,31979,4563
987654563,arun,61042,29240,31802,4563
987654563,arun,108793,32840,75953,4563
987654563,arun,103359,83510,19849,4563
987654563,arun,105240,41820,63420,4563
987654563,arun,103898,37530,66368,4563
987654563,arun,121245,84730,36515,4563
987654563,arun,67653,57500,10153,4563
987654563,arun,104459,30670,73789,4563
987654564,virender,93569,33400,60169,4564
987654564,virender,70095,61430,8665,4564
987654564,virender,74044,38830,35214,4564
987654564,virender,53309,49320,3989,4564
987654564,virender,88784,66550,22234,4564
987654564,virender,85264,52740,32524,4564
987654564,virender,87178,75450,11728,4564
987654564,virender,102193,29480,72713,4564
987654564,virender,101148,46540,54608,4564
987654564,virender,54596,52190,2406,4564
987654564,virender,83746,74440,9306,4564
987654564,virender,68907,42010,26897,4564
987654564,virender,78290,38310,39980,4564
987654564,virender,75089,58520,16569,4564
987654564,virender,78774,61010,17764,4564
987654564,virender,65794,52440,13354,4564
987654564,virender,96594,58510,38084,4564
987654564,virender,89455,46920,42535,4564
987654564,virender,98409,92490,5919,4564
987654564,virender,111972,105700,6272,4564
987654564,virender,121564,71500,50064,4564
987654564,virender,66058,63350,2708,4564
987654564,virender,123225,71560,51665,4564
987654564,virender,109288,98870,10418,4564
987654565,bishun,112005,86370,25635,4565
987654565,bishun,110938,38780,72158,4565
987654565,bishun,54607,50680,3927,4565
987654565,bishun,72108,39910,32198,4565
987654565,bishun,64419,47510,16909,4565
987654565,bishun,76475,63590,12885,4565
987654565,bishun,91864,27020,64844,4565
987654565,bishun,76409,64550,11859,4565
987654565,bishun,112731,84470,28261,4565
987654565,bishun,120409,74710,45699,4565
987654565,bishun,120343,109730,10613,4565
987654565,bishun,133356,119660,13696,4565
987654565,bishun,56818,18060,38758,4565
987654565,bishun,80644,66140,14504,4565
987654565,bishun,73703,64410,9293,4565
987654565,bishun,76233,50110,26123,4565
987654565,bishun,77355,56160,21195,4565
987654565,bishun,79720,58490,21230,4565
987654565,bishun,58127,43680,14447,4565
987654565,bishun,87618,35130,52488,4565
987654565,bishun,96891,43370,53521,4565
987654565,bishun,99509,84890,14619,4565
987654565,bishun,107363,86200,21163,4565
987654565,bishun,119540,105540,14000,4565
987654566,pritam singh,51989,31570,20419,4566
987654566,pritam singh,85671,75250,10421,4566
987654566,pritam singh,78345,27900,50445,4566
987654566,pritam singh,70667,53480,17187,4566
987654566,pritam singh,83372,59940,23432,4566
987654566,pritam singh,79775,45440,34335,4566
987654566,pritam singh,53683,47430,6253,4566
987654566,pritam singh,83581,80500,3081,4566
987654566,pritam singh,78862,41020,37842,4566
987654566,pritam singh,88355,30150,58205,4566
987654566,pritam singh,93140,56630,36510,4566
987654566,pritam singh,104547,33580,70967,4566
987654566,pritam singh,57302,39930,17372,4566
987654566,pritam singh,70007,43560,26447,4566
987654566,pritam singh,78741,58000,20741,4566
987654566,pritam singh,65761,34770,30991,4566
987654566,pritam singh,78466,25770,52696,4566
987654566,pritam singh,76871,75010,1861,4566
987654566,pritam singh,55245,42620,12625,4566
987654566,pritam singh,82690,24790,57900,4566
987654566,pritam singh,85891,52740,33151,4566
987654566,pritam singh,96385,26480,69905,4566
987654566,pritam singh,96979,44780,52199,4566
987654566,pritam singh,118077,98370,19707,4566
987654567,akash gupta,64958,35620,29338,4567
987654567,akash gupta,92645,58670,33975,4567
987654567,akash gupta,73791,71100,2691,4567
987654567,akash gupta,70909,46360,24549,4567
987654567,akash gupta,70568,21990,48578,4567
987654567,akash gupta,77344,48680,28664,4567
987654567,akash gupta,53012,52780,232,4567
987654567,akash gupta,78422,69760,8662,4567
987654567,akash gupta,84109,61300,22809,4567
987654567,akash gupta,96946,80070,16876,4567
987654567,akash gupta,92568,37820,54748,4567
987654567,akash gupta,120585,53670,66915,4567
987654567,akash gupta,52363,33160,19203,4567
987654567,akash gupta,88344,71690,16654,4567
987654567,akash gupta,67400,18480,48920,4567
987654567,akash gupta,78367,29470,48897,4567
987654567,akash gupta,74858,63670,11188,4567
987654567,akash gupta,73736,21390,52346,4567
987654567,akash gupta,57830,32230,25600,4567
987654567,akash gupta,90478,25120,65358,4567
987654567,akash gupta,94878,52900,41978,4567
987654567,akash gupta,93437,45410,48027,4567
987654567,akash gupta,103843,34220,69623,4567
987654567,akash gupta,124446,76220,48226,4567
987654568,kishan,59700,35780,23920,4568
987654568,kishan,82954,25770,57184,4568
987654568,kishan,72449,46810,25639,4568
987654568,kishan,67675,47710,19965,4568
987654568,kishan,75584,19450,56134,4568
987654568,kishan,74132,26700,47432,4568
987654568,kishan,55135,31590,23545,4568
987654568,kishan,81799,68050,13749,4568
987654568,kishan,86903,85430,1473,4568
987654568,kishan,92183,54160,38023,4568
987654568,kishan,113402,78980,34422,4568
987654568,kishan,119837,82260,37577,4568
987654568,kishan,56202,50890,5312,4568
987654568,kishan,75133,66010,9123,4568
987654568,kishan,73065,21570,51495,4568
987654568,kishan,73747,61580,12167,4568
987654568,kishan,75716,26790,48926,4568
987654568,kishan,75826,35080,40746,4568
987654568,kishan,51087,15780,35307,4568
987654568,kishan,89939,37510,52429,4568
987654568,kishan,100202,38980,61222,4568
987654568,kishan,107506,29200,78306,4568
987654568,kishan,144543,39410,105133,4568
987654568,kishan,56180,24070,32110,4568
987654569,mohd kausar,77806,69150,8656,4569
987654569,mohd kausar,82855,76350,6505,4569
987654569,mohd kausar,46896,25460,21436,4569
987654569,mohd kausar,97386,25040,72346,4569
987654569,mohd kausar,62065,18130,43935,4569
987654569,mohd kausar,88949,33180,55769,4569
987654569,mohd kausar,70997,38240,32757,4569
987654569,mohd kausar,152375,74250,78125,4569
987654569,mohd kausar,96979,56020,40959,4569
987654569,mohd kausar,122609,44220,78389,4569
987654569,mohd kausar,118374,63540,54834,4569
987654569,mohd kausar,134929,126190,8739,4569
987654569,mohd kausar,143883,42330,101553,4569
987654569,mohd kausar,168248,52670,115578,4569
987654569,mohd kausar,72460,30540,41920,4569
987654569,mohd kausar,81183,30040,51143,4569
987654569,mohd kausar,77817,19720,58097,4569
987654569,mohd kausar,79698,28810,50888,4569
987654569,mohd kausar,85374,52180,33194,4569
987654569,mohd kausar,83262,49160,34102,4569
987654569,mohd kausar,63891,43790,20101,4569
987654569,mohd kausar,99135,73070,26065,4569
987654569,mohd kausar,122444,115100,7344,4569
987654569,mohd kausar,105900,38680,67220,4569
987654570,sachin,117417,51080,66337,4570
987654570,sachin,131992,50060,81932,4570
987654570,sachin,79720,40230,39490,4570
987654570,sachin,98739,74110,24629,4570
987654570,sachin,84197,71680,12517,4570
987654570,sachin,80215,49080,31135,4570
987654570,sachin,82756,66480,16276,4570
987654570,sachin,94911,62430,32481,4570
987654570,sachin,56180,39630,16550,4570
987654570,sachin,93305,67450,25855,4570
987654570,sachin,81315,76550,4765,4570
987654570,sachin,87321,62010,25311,4570
987654570,sachin,93822,64280,29542,4570
987654570,sachin,111939,51030,60909,4570
987654570,sachin,63924,38530,25394,4570
987654570,sachin,74935,46850,28085,4570
987654570,sachin,68159,41020,27139,4570
987654570,sachin,63979,50270,13709,4570
987654570,sachin,81678,53550,28128,4570
987654570,sachin,72856,18600,54256,4570
987654570,sachin,62208,29150,33058,4570
987654570,sachin,85484,77310,8174,4570
987654570,sachin,84604,80930,3674,4570
987654570,sachin,87937,28620,59317,4570
987654571,harman singh,105207,97520,7687,4571
987654571,harman singh,119089,74070,45019,4571
987654571,harman singh,65706,52280,13426,4571
987654571,harman singh,92084,26970,65114,4571
987654571,harman singh,77256,62010,15246,4571
987654571,harman singh,76266,67400,8866,4571
987654571,harman singh,69754,37360,32394,4571
987654571,harman singh,54024,43630,10394,4571
987654571,harman singh,78015,77390,625,4571
987654571,harman singh,83449,69490,13959,4571
987654571,harman singh,72229,34600,37629,4571
987654571,harman singh,87948,85430,2518,4571
987654571,harman singh,105383,102220,3163,4571
987654571,harman singh,48117,23620,24497,4571
987654571,harman singh,68203,63490,4713,4571
987654571,harman singh,77223,72980,4243,4571
987654571,harman singh,83636,30990,52646,4571
987654571,harman singh,68357,52910,15447,4571
987654571,harman singh,82151,24070,58081,4571
987654571,harman singh,61328,45060,16268,4571
987654571,harman singh,96396,76290,20106,4571
987654571,harman singh,81458,56050,25408,4571
987654571,harman singh,85044,40730,44314,4571
987654571,harman singh,99597,33560,66037,4571
987654572,deepak,115613,75600,40013,4572
987654572,deepak,49118,36170,12948,4572
987654572,deepak,85286,71970,13316,4572
987654572,deepak,81304,35850,45454,4572
987654572,deepak,83064,52380,30684,4572
987654572,deepak,87827,66930,20897,4572
987654572,deepak,52319,18010,34309,4572
987654572,deepak,90808,36830,53978,4572
987654572,deepak,88410,84270,4140,4572
987654572,deepak,86419,79280,7139,4572
987654572,deepak,90049,85580,4469,4572
987654572,deepak,101654,39970,61684,4572
987654572,deepak,49470,28730,20740,4572
987654572,deepak,69864,52740,17124,4572
987654572,deepak,62989,40240,22749,4572
987654572,deepak,67950,66170,1780,4572
987654572,deepak,70557,25010,45547,4572
987654572,deepak,76255,50710,25545,4572
987654572,deepak,52462,15440,37022,4572
987654572,deepak,93888,55470,38418,4572
987654572,deepak,88674,36780,51894,4572
987654572,deepak,91776,75260,16516,4572
987654572,deepak,99608,64950,34658,4572
987654572,deepak,131640,67150,64490,4572
987654573,rajbir,51868,36400,15468,4573
987654573,rajbir,67444,21290,46154,4573
987654573,rajbir,70370,31820,38550,4573
987654573,rajbir,67631,28470,39161,4573
987654573,rajbir,72163,45910,26253,4573
987654573,rajbir,79940,39390,40550,4573
987654573,rajbir,48315,38950,9365,4573
987654573,rajbir,85275,47090,38185,4573
987654573,rajbir,78367,29650,48717,4573
987654573,rajbir,75188,44620,30568,4573
987654573,rajbir,80996,27610,53386,4573
987654573,rajbir,93019,32630,60389,4573
987654573,rajbir,43519,25810,17709,4573
987654573,rajbir,61218,57070,4148,4573
987654573,rajbir,58523,55310,3213,4573
987654573,rajbir,63682,51530,12152,4573
987654573,rajbir,68346,58170,10176,4573
987654573,rajbir,63572,36530,27042,4573
987654573,rajbir,46357,21200,25157,4573
987654573,rajbir,88806,76330,12476,4573
987654573,rajbir,78466,25610,52856,4573
987654573,rajbir,85022,62970,22052,4573
987654573,rajbir,96440,94240,2200,4573
987654573,rajbir,111708,82430,29278,4573
987654574,vinod lal,54024,16930,37094,4574
987654574,vinod lal,71063,66620,4443,4574
987654574,vinod lal,69842,34270,35572,4574
987654574,vinod lal,71184,64320,6864,4574
987654574,vinod lal,64551,19910,44641,4574
987654574,vinod lal,75804,42130,33674,4574
987654574,vinod lal,54618,33010,21608,4574
987654574,vinod lal,87772,64310,23462,4574
987654574,vinod lal,95549,67950,27599,4574
987654574,vinod lal,104591,76720,27871,4574
987654574,vinod lal,115426,60530,54896,4574
987654574,vinod lal,112874,80060,32814,4574
987654574,vinod lal,55190,28310,26880,4574
987654574,vinod lal,76673,25070,51603,4574
987654574,vinod lal,84164,75000,9164,4574
987654574,vinod lal,76310,37470,38840,4574
987654574,vinod lal,71844,69920,1924,4574
987654574,vinod lal,69270,69070,200,4574
987654574,vinod lal,57324,52300,5024,4574
987654574,vinod lal,90379,63680,26699,4574
987654574,vinod lal,86430,35550,50880,4574
987654574,vinod lal,99245,86100,13145,4574
987654574,vinod lal,99311,76220,23091,4574
987654574,vinod lal,124666,35390,89276,4574
987654575,amisha,52814,47690,5124,4575
987654575,amisha,80171,44460,35711,4575
987654575,amisha,68357,42990,25367,4575
987654575,amisha,71272,44030,27242,4575
987654575,amisha,73065,39730,33335,4575
987654575,amisha,81447,49360,32087,4575
987654575,amisha,53397,26300,27097,4575
987654575,amisha,85517,78680,6837,4575
987654575,amisha,94867,51720,43147,4575
987654575,amisha,94339,83420,10919,4575
987654575,amisha,98816,51840,46976,4575
987654575,amisha,118924,55070,63854,4575
987654575,amisha,44454,14640,29814,4575
987654575,amisha,85220,44560,40660,4575
987654575,amisha,73571,36020,37551,4575
987654575,amisha,71558,56740,14818,4575
987654575,amisha,72185,47380,24805,4575
987654575,amisha,71822,27930,43892,4575
987654575,amisha,54387,29970,24417,4575
987654575,amisha,92117,64510,27607,4575
987654575,amisha,80677,54270,26407,4575
987654575,amisha,86287,50810,35477,4575
987654575,amisha,92799,28320,64479,4575
987654575,amisha,98585,47300,51285,4575
987654576,chander shaker,58600,39880,18720,4576
987654576,chander shaker,78455,36680,41775,4576
987654576,chander shaker,66531,65500,1031,4576
987654576,chander shaker,71107,21200,49907,4576
987654576,chander shaker,75958,31170,44788,4576
987654576,chander shaker,71448,21790,49658,4576
987654576,chander shaker,55971,36420,19551,4576
987654576,chander shaker,88355,56650,31705,4576
987654576,chander shaker,79566,56870,22696,4576
987654576,chander shaker,89752,84240,5512,4576
987654576,chander shaker,99025,45740,53285,4576
987654576,chander shaker,110817,77200,33617,4576
987654576,chander shaker,57841,36530,21311,4576
987654576,chander shaker,101907,58850,43057,4576
987654576,chander shaker,98596,72130,26466,4576
987654576,chander shaker,82074,74220,7854,4576
987654576,chander shaker,98552,42420,56132,4576
987654576,chander shaker,48293,44430,3863,4576
987654576,chander shaker,62692,48220,14472,4576
987654576,chander shaker,66146,50580,15566,4576
987654576,chander shaker,70766,63970,6796,4576
987654576,chander shaker,81095,70250,10845,4576
987654576,chander shaker,57907,35400,22507,4576
987654576,chander shaker,92216,76580,15636,4576
987654577,krishan,80490,34920,45570,4577
987654577,krishan,94845,82770,12075,4577
987654577,krishan,98706,59450,39256,4577
987654577,krishan,101412,86470,14942,4577
987654577,krishan,61526,60720,806,4577
987654577,krishan,88179,36620,51559,4577
987654577,krishan,82525,43390,39135,4577
987654577,krishan,81216,77450,3766,4577
987654577,krishan,71998,40730,31268,4577
987654577,krishan,58600,49530,9070,4577
987654577,krishan,90984,25080,65904,4577
987654577,krishan,102006,29040,72966,4577
987654577,krishan,114942,47460,67482,4577
987654577,krishan,105999,92930,13069,4577
987654577,krishan,53870,46880,6990,4577
987654577,krishan,77003,39610,37393,4577
987654577,krishan,78851,44490,34361,4577
987654577,krishan,81271,31890,49381,4577
987654577,krishan,91622,50030,41592,4577
987654577,krishan,95824,95180,644,4577
987654577,krishan,44993,19080,25913,4577
987654577,krishan,67499,56780,10719,4577
987654577,krishan,63748,63230,518,4577
987654577,krishan,63660,40840,22820,4577
987654578,ram ji,67719,63110,4609,4578
987654578,ram ji,64705,54800,9905,4578
987654578,ram ji,45532,37340,8192,4578
987654578,ram ji,80457,78720,1737,4578
987654578,ram ji,76794,47110,29684,4578
987654578,ram ji,82547,60520,22027,4578
987654578,ram ji,98266,64100,34166,4578
987654578,ram ji,116361,58970,57391,4578
987654578,ram ji,49184,38540,10644,4578
987654578,ram ji,71261,60100,11161,4578
987654578,ram ji,70150,44120,26030,4578
987654578,ram ji,71679,65790,5889,4578
987654578,ram ji,80644,76600,4044,4578
987654578,ram ji,82338,34340,47998,4578
987654578,ram ji,108980,41780,67200,4578
987654578,ram ji,96814,88190,8624,4578
987654578,ram ji,102072,41550,60522,4578
987654578,ram ji,115712,39690,76022,4578
987654578,ram ji,56752,42870,13882,4578
987654578,ram ji,86716,47580,39136,4578
987654578,ram ji,82921,47090,35831,4578
987654578,ram ji,87409,87160,249,4578
987654578,ram ji,98365,51460,46905,4578
987654578,ram ji,103689,74580,29109,4578
987654579,jony,54442,29370,25072,4579
987654579,jony,78334,48350,29984,4579
987654579,jony,75980,23590,52390,4579
987654579,jony,61031,27830,33201,4579
987654579,jony,75870,70600,5270,4579
987654579,jony,85440,21510,63930,4579
987654579,jony,53617,31110,22507,4579
987654579,jony,79038,49170,29868,4579
987654579,jony,84538,25890,58648,4579
987654579,jony,84989,73490,11499,4579
987654579,jony,92051,67960,24091,4579
987654579,jony,110212,56910,53302,4579
987654579,jony,52209,47050,5159,4579
987654579,jony,75782,61390,14392,4579
987654579,jony,75969,39940,36029,4579
987654579,jony,71844,58160,13684,4579
987654579,jony,63781,33630,30151,4579
987654579,jony,61746,57920,3826,4579
987654579,jony,48238,35360,12878,4579
987654579,jony,76783,34410,42373,4579
987654579,jony,71129,56500,14629,4579
987654579,jony,77641,72380,5261,4579
987654579,jony,91248,88820,2428,4579
987654579,jony,110729,33330,77399,4579
987654580,mohammad ali,50757,18410,32347,4580
987654580,mohammad ali,61449,30770,30679,4580
987654580,mohammad ali,65662,30850,34812,4580
987654580,mohammad ali,68731,55690,13041,4580
987654580,mohammad ali,63528,34070,29458,4580
987654580,mohammad ali,64375,20460,43915,4580
987654580,mohammad ali,53232,31000,22232,4580
987654580,mohammad ali,87761,61810,25951,4580
987654580,mohammad ali,83691,63190,20501,4580
987654580,mohammad ali,84439,33950,50489,4580
987654580,mohammad ali,94889,77350,17539,4580
987654580,mohammad ali,96638,51050,45588,4580
987654580,mohammad ali,53243,51100,2143,4580
987654580,mohammad ali,68566,43440,25126,4580
987654580,mohammad ali,67587,57940,9647,4580
987654580,mohammad ali,60591,36800,23791,4580
987654580,mohammad ali,60008,38140,21868,4580
987654580,mohammad ali,71833,68970,2863,4580
987654580,mohammad ali,47358,39170,8188,4580
987654580,mohammad ali,82228,73560,8668,4580
987654580,mohammad ali,75870,56400,19470,4580
987654580,mohammad ali,89048,59960,29088,4580
987654580,mohammad ali,86111,77070,9041,4580
987654580,mohammad ali,102864,101780,1084,4580
987654581,ashok kumar s/o,43497,28070,15427,4581
987654581,ashok kumar s/o,55520,42910,12610,4581
987654581,ashok kumar s/o,56664,20500,36164,4581
987654581,ashok kumar s/o,62076,19960,42116,4581
987654581,ashok kumar s/o,65981,42630,23351,4581
987654581,ashok kumar s/o,67532,66870,662,4581
987654581,ashok kumar s/o,50229,42320,7909,4581
987654581,ashok kumar s/o,82558,58720,23838,4581
987654581,ashok kumar s/o,77267,23320,53947,4581
987654581,ashok kumar s/o,86958,33820,53138,4581
987654581,ashok kumar s/o,92150,59720,32430,4581
987654581,ashok kumar s/o,110223,62760,47463,4581
987654581,ashok kumar s/o,47886,14360,33526,4581
987654581,ashok kumar s/o,64848,22090,42758,4581
987654581,ashok kumar s/o,62230,61860,370,4581
987654581,ashok kumar s/o,76189,72040,4149,4581
987654581,ashok kumar s/o,110861,64840,46021,4581
987654581,ashok kumar s/o,81051,66680,14371,4581
987654581,ashok kumar s/o,86243,77700,8543,4581
987654581,ashok kumar s/o,84824,58020,26804,4581
987654581,ashok kumar s/o,110685,56050,54635,4581
987654581,ashok kumar s/o,48656,27180,21476,4581
987654581,ashok kumar s/o,70579,27240,43339,4581
987654581,ashok kumar s/o,71030,61190,9840,4581
987654582,ravinder,65420,21190,44230,4582
987654582,ravinder,57357,22080,35277,4582
987654582,ravinder,69776,50480,19296,4582
987654582,ravinder,51527,37320,14207,4582
987654582,ravinder,84340,58490,25850,4582
987654582,ravinder,75837,23420,52417,4582
987654582,ravinder,87343,35860,51483,4582
987654582,ravinder,84032,21670,62362,4582
987654582,ravinder,108837,85770,23067,4582
987654582,ravinder,54420,42880,11540,4582
987654582,ravinder,86078,49500,36578,4582
987654582,ravinder,70282,40160,30122,4582
987654582,ravinder,73516,63660,9856,4582
987654582,ravinder,61977,58230,3747,4582
987654582,ravinder,72834,29960,42874,4582
987654582,ravinder,55091,24570,30521,4582
987654582,ravinder,85990,34530,51460,4582
987654582,ravinder,87761,46480,41281,4582
987654582,ravinder,79445,70490,8955,4582
987654582,ravinder,119298,116850,2448,4582
987654582,ravinder,123544,76190,47354,4582
987654582,ravinder,50658,23700,26958,4582
987654582,ravinder,68082,52090,15992,4582
987654582,ravinder,67840,48380,19460,4582
987654583,amit,66454,42320,24134,4583
987654583,amit,63385,56910,6475,4583
987654583,amit,64078,57380,6698,4583
987654583,amit,51461,44900,6561,4583
987654583,amit,91050,73700,17350,4583
987654583,amit,86078,33990,52088,4583
987654583,amit,90214,71610,18604,4583
987654583,amit,93448,51380,42068,4583
987654583,amit,114502,76420,38082,4583
987654583,amit,48887,34150,14737,4583
987654583,amit,80083,25350,54733,4583
987654583,amit,57390,22790,34600,4583
987654583,amit,65783,39710,26073,4583
987654583,amit,69347,66030,3317,4583
987654583,amit,71316,45810,25506,4583
987654583,amit,52220,20830,31390,4583
987654583,amit,90643,65480,25163,4583
987654583,amit,85077,70610,14467,4583
987654583,amit,87706,60960,26746,4583
987654583,amit,95219,58460,36759,4583
987654583,amit,114183,103290,10893,4583
987654583,amit,70942,50250,20692,4583
987654583,amit,98893,70330,28563,4583
987654583,amit,69479,22730,46749,4583
987654584,guman singh basyal,66872,48830,18042,4584
987654584,guman singh basyal,72042,58780,13262,4584
987654584,guman singh basyal,47204,40390,6814,4584
987654584,guman singh basyal,83889,65320,18569,4584
987654584,guman singh basyal,75551,67370,8181,4584
987654584,guman singh basyal,92513,88990,3523,4584
987654584,guman singh basyal,90170,54590,35580,4584
987654584,guman singh basyal,102809,65730,37079,4584
987654584,guman singh basyal,53650,41930,11720,4584
987654584,guman singh basyal,83471,44020,39451,4584
987654584,guman singh basyal,83526,49430,34096,4584
987654584,guman singh basyal,70084,29210,40874,4584
987654584,guman singh basyal,65266,29730,35536,4584
987654584,guman singh basyal,58831,49240,9591,4584
987654584,guman singh basyal,91072,73550,17522,4584
987654584,guman singh basyal,84967,73000,11967,4584
987654584,guman singh basyal,90841,88280,2561,4584
987654584,guman singh basyal,78873,49610,29263,4584
987654584,guman singh basyal,114139,62140,51999,4584
987654584,guman singh basyal,72845,60090,12755,4584
987654584,guman singh basyal,108463,28810,79653,4584
987654584,guman singh basyal,87607,47140,40467,4584
987654584,guman singh basyal,93767,33940,59827,4584
987654584,guman singh basyal,107022,45550,61472,4584
987654585,amardeep,50812,15180,35632,4585
987654585,amardeep,69556,39160,30396,4585
987654585,amardeep,56961,52270,4691,4585
987654585,amardeep,67015,62230,4785,4585
987654585,amardeep,56576,26740,29836,4585
987654585,amardeep,63770,49670,14100,4585
987654585,amardeep,53342,15720,37622,4585
987654585,amardeep,94372,84580,9792,4585
987654585,amardeep,84285,28300,55985,4585
987654585,amardeep,75397,66900,8497,4585
987654585,amardeep,87013,41240,45773,4585
987654585,amardeep,104019,56930,47089,4585
987654585,amardeep,47578,19300,28278,4585
987654585,amardeep,67972,44760,23212,4585
987654585,amardeep,62758,23920,38838,4585
987654585,amardeep,70194,69900,294,4585
987654585,amardeep,75485,68050,7435,4585
987654585,amardeep,80941,75650,5291,4585
987654585,amardeep,105306,41980,63326,4585
987654585,amardeep,105636,83790,21846,4585
987654585,amardeep,124798,78440,46358,4585
987654585,amardeep,137283,128820,8463,4585
987654585,amardeep,57280,45460,11820,4585
987654585,amardeep,73769,60600,13169,4585
987654586,jagdish,66993,27200,39793,4586
987654586,jagdish,60294,49910,10384,4586
987654586,jagdish,64914,41010,23904,4586
987654586,jagdish,65244,55270,9974,4586
987654586,jagdish,55344,52400,2944,4586
987654586,jagdish,91149,81800,9349,4586
987654586,jagdish,83581,54200,29381,4586
987654586,jagdish,87607,52600,35007,4586
987654586,jagdish,84934,81790,3144,4586
987654586,jagdish,109640,60430,49210,4586
987654586,jagdish,50647,25900,24747,4586
987654586,jagdish,64760,26820,37940,4586
987654586,jagdish,65420,18760,46660,4586
987654586,jagdish,67400,18350,49050,4586
987654586,jagdish,65827,40590,25237,4586
987654586,jagdish,77113,50840,26273,4586
987654586,jagdish,51604,38780,12824,4586
987654586,jagdish,91754,61280,30474,4586
987654586,jagdish,82866,68470,14396,4586
987654586,jagdish,82844,37800,45044,4586
987654586,jagdish,84923,65330,19593,4586
987654586,jagdish,108331,68430,39901,4586
987654586,jagdish,59359,43770,15589,4586
987654586,jagdish,87816,65750,22066,4586
987654587,bharat,62967,51260,11707,4587
987654587,bharat,65640,53670,11970,4587
987654587,bharat,62846,59700,3146,4587
987654587,bharat,61922,16260,45662,4587
987654587,bharat,48062,39710,8352,4587
987654587,bharat,85781,60940,24841,4587
987654587,bharat,80380,79820,560,4587
987654587,bharat,80413,62360,18053,4587
987654587,bharat,76277,38310,37967,4587
987654587,bharat,111290,92430,18860,4587
987654587,bharat,55432,39250,16182,4587
987654587,bharat,82503,34990,47513,4587
987654587,bharat,61416,18560,42856,4587
987654587,bharat,69072,60280,8792,4587
987654587,bharat,57830,43830,14000,4587
987654587,bharat,63539,33090,30449,4587
987654587,bharat,52000,31390,20610,4587
987654587,bharat,93657,65830,27827,4587
987654587,bharat,79456,53960,25496,4587
987654587,bharat,78664,56530,22134,4587
987654587,bharat,72746,44640,28106,4587
987654587,bharat,101544,29990,71554,4587
987654587,bharat,62934,39070,23864,4587
987654587,bharat,109431,32620,76811,4587
987654588,azaz,77311,59280,18031,4588
987654588,azaz,85605,58860,26745,4588
987654588,azaz,74242,33740,40502,4588
987654588,azaz,99806,89220,10586,4588
987654588,azaz,50262,42740,7522,4588
987654588,azaz,68291,30540,37751,4588
987654588,azaz,56257,51390,4867,4588
987654588,azaz,55289,22020,33269,4588
987654588,azaz,51505,13120,38385,4588
987654588,azaz,61075,44980,16095,4588
987654588,azaz,57027,15910,41117,4588
987654588,azaz,84758,60400,24358,4588
987654588,azaz,90951,70630,20321,4588
987654588,azaz,87552,77250,10302,4588
987654588,azaz,91556,72460,19096,4588
987654588,azaz,104371,35150,69221,4588
987654588,azaz,48139,34700,13439,4588
987654588,azaz,88454,69140,19314,4588
987654588,azaz,82734,52780,29954,4588
987654588,azaz,77168,29270,47898,4588
987654588,azaz,104481,63690,40791,4588
987654588,azaz,101280,59880,41400,4588
987654588,azaz,57071,33470,23601,4588
987654588,azaz,74803,36880,37923,4588
987654589,raja kumar,47226,31390,15836,4589
987654589,raja kumar,83867,69320,14547,4589
987654589,raja kumar,75628,68850,6778,4589
987654589,raja kumar,71547,23330,48217,4589
987654589,raja kumar,50746,31790,18956,4589
987654589,raja kumar,133939,108520,25419,4589
987654589,raja kumar,136557,120770,15787,4589
987654589,raja kumar,81678,53190,28488,4589
987654589,raja kumar,126712,73670,53042,4589
987654589,raja kumar,117681,71350,46331,4589
987654589,raja kumar,117197,74550,42647,4589
987654589,raja kumar,127702,50680,77022,4589
987654589,raja kumar,136513,84540,51973,4589
987654589,raja kumar,64408,21890,42518,4589
987654589,raja kumar,92711,56280,36431,4589
987654589,raja kumar,76915,28900,48015,4589
987654589,raja kumar,85902,32030,53872,4589
987654589,raja kumar,74737,63670,11067,4589
987654589,raja kumar,80237,35870,44367,4589
987654589,raja kumar,57676,48140,9536,4589
987654589,raja kumar,125656,75490,50166,4589
987654589,raja kumar,100785,88390,12395,4589
987654589,raja kumar,91215,39550,51665,4589
987654589,raja kumar,102589,90290,12299,4589
987654590,parveen,123742,108340,15402,4590
987654590,parveen,65563,21210,44353,4590
987654590,parveen,113578,113120,458,4590
987654590,parveen,85154,75970,9184,4590
987654590,parveen,91358,47870,43488,4590
987654590,parveen,87354,59430,27924,4590
987654590,parveen,101027,38880,62147,4590
987654590,parveen,50911,28600,22311,4590
987654590,parveen,73164,62700,10464,4590
987654590,parveen,60998,52250,8748,4590
987654590,parveen,78532,67270,11262,4590
987654590,parveen,61724,44190,17534,4590
987654590,parveen,65222,43070,22152,4590
987654590,parveen,56554,50760,5794,4590
987654590,parveen,81106,49890,31216,4590
987654590,parveen,76893,70740,6153,4590
987654590,parveen,76871,30410,46461,4590
987654590,parveen,75386,20290,55096,4590
987654590,parveen,90709,67070,23639,4590
987654590,parveen,53342,46110,7232,4590
987654590,parveen,102028,47730,54298,4590
987654590,parveen,83416,40610,42806,4590
987654590,parveen,96319,61300,35019,4590
987654590,parveen,94229,89420,4809,4590
987654591,mahabir prasad,111191,45220,65971,4591
987654591,mahabir prasad,67675,26650,41025,4591
987654591,mahabir prasad,98090,24630,73460,4591
987654591,mahabir prasad,67004,57960,9044,4591
987654591,mahabir prasad,61823,18600,43223,4591
987654591,mahabir prasad,68225,54630,13595,4591
987654591,mahabir prasad,51890,39700,12190,4591
987654591,mahabir prasad,82899,40340,42559,4591
987654591,mahabir prasad,73010,25120,47890,4591
987654591,mahabir prasad,77586,39390,38196,4591
987654591,mahabir prasad,80842,47010,33832,4591
987654591,mahabir prasad,94988,79410,15578,4591
987654591,mahabir prasad,48326,19340,28986,4591
987654591,mahabir prasad,76662,52900,23762,4591
987654591,mahabir prasad,61141,49790,11351,4591
987654591,mahabir prasad,65068,36640,28428,4591
987654591,mahabir prasad,59788,17710,42078,4591
987654591,mahabir prasad,63891,47660,16231,4591
987654591,mahabir prasad,55443,52990,2453,4591
987654591,mahabir prasad,83306,71940,11366,4591
987654591,mahabir prasad,71162,61250,9912,4591
987654591,mahabir prasad,84406,28670,55736,4591
987654591,mahabir prasad,76695,57820,18875,4591
987654591,mahabir prasad,107198,74080,33118,4591
987654592,kartik ,71162,57580,13582,4592
987654592,kartik ,78631,37810,40821,4592
987654592,kartik ,82877,68200,14677,4592
987654592,kartik ,110542,102320,8222,4592
987654592,kartik ,104943,27910,77033,4592
987654592,kartik ,43717,42630,1087,4592
987654592,kartik ,69380,56000,13380,4592
987654592,kartik ,60778,46810,13968,4592
987654592,kartik ,55278,26170,29108,4592
987654592,kartik ,52572,45450,7122,4592
987654592,kartik ,63715,26420,37295,4592
987654592,kartik ,43838,32070,11768,4592
987654592,kartik ,78598,64240,14358,4592
987654592,kartik ,74726,58930,15796,4592
987654592,kartik ,79412,32750,46662,4592
987654592,kartik ,82855,22370,60485,4592
987654592,kartik ,101203,86450,14753,4592
987654592,kartik ,49558,34880,14678,4592
987654592,kartik ,64958,43530,21428,4592
987654592,kartik ,66751,62910,3841,4592
987654592,kartik ,65640,44930,20710,4592
987654592,kartik ,61856,29940,31916,4592
987654592,kartik ,67356,18550,48806,4592
987654592,kartik ,46555,31930,14625,4592
987654593,shubham yadav,79676,56560,23116,4593
987654593,shubham yadav,72845,39640,33205,4593
987654593,shubham yadav,84681,74610,10071,4593
987654593,shubham yadav,78851,43280,35571,4593
987654593,shubham yadav,110344,49110,61234,4593
987654593,shubham yadav,61119,41980,19139,4593
987654593,shubham yadav,93591,52650,40941,4593
987654593,shubham yadav,57159,51480,5679,4593
987654593,shubham yadav,59678,50080,9598,4593
987654593,shubham yadav,58237,16150,42087,4593
987654593,shubham yadav,67290,22990,44300,4593
987654593,shubham yadav,48161,41080,7081,4593
987654593,shubham yadav,78818,42160,36658,4593
987654593,shubham yadav,70051,23300,46751,4593
987654593,shubham yadav,83746,26170,57576,4593
987654593,shubham yadav,79324,72930,6394,4593
987654593,shubham yadav,101478,31400,70078,4593
987654593,shubham yadav,48414,15570,32844,4593
987654593,shubham yadav,73043,27950,45093,4593
987654593,shubham yadav,63363,33780,29583,4593
987654593,shubham yadav,62714,34760,27954,4593
987654593,shubham yadav,56961,53580,3381,4593
987654593,shubham yadav,63022,33420,29602,4593
987654593,shubham yadav,49195,41080,8115,4593
987654594,yogesh,78961,49680,29281,4594
987654594,yogesh,69314,31720,37594,4594
987654594,yogesh,72955,26510,46445,4594
987654594,yogesh,67631,64280,3351,4594
987654594,yogesh,88113,52830,35283,4594
987654594,yogesh,53232,16790,36442,4594
987654594,yogesh,96198,65540,30658,4594
987654594,yogesh,92579,50760,41819,4594
987654594,yogesh,78686,40890,37796,4594
987654594,yogesh,67807,25440,42367,4594
987654594,yogesh,95142,71800,23342,4594
987654594,yogesh,43728,42310,1418,4594
987654594,yogesh,70117,67560,2557,4594
987654594,yogesh,63011,62290,721,4594
987654594,yogesh,64364,21040,43324,4594
987654594,yogesh,61075,52470,8605,4594
987654594,yogesh,64584,56390,8194,4594
987654594,yogesh,46005,20500,25505,4594
987654594,yogesh,82382,29250,53132,4594
987654594,yogesh,77454,39100,38354,4594
987654594,yogesh,84340,68520,15820,4594
987654594,yogesh,81810,20560,61250,4594
987654594,yogesh,97320,73370,23950,4594
987654594,yogesh,53584,41810,11774,4594
987654595,madan,70909,34560,36349,4595
987654595,madan,57280,49970,7310,4595
987654595,madan,59183,29140,30043,4595
987654595,madan,59546,27350,32196,4595
987654595,madan,64672,30710,33962,4595
987654595,madan,49767,13900,35867,4595
987654595,madan,85132,73940,11192,4595
987654595,madan,69908,32010,37898,4595
987654595,madan,78411,68740,9671,4595
987654595,madan,75386,26830,48556,4595
987654595,madan,140902,88730,52172,4595
987654595,madan,50911,28830,22081,4595
987654595,madan,74121,40950,33171,4595
987654595,madan,61559,44730,16829,4595
987654595,madan,62274,32000,30274,4595
987654595,madan,52209,48490,3719,4595
987654595,madan,65937,17750,48187,4595
987654595,madan,47061,44900,2161,4595
987654595,madan,83746,56410,27336,4595
987654595,madan,74473,67810,6663,4595
987654595,madan,74792,34070,40722,4595
987654595,madan,77916,67940,9976,4595
987654595,madan,108705,79910,28795,4595
987654595,madan,51395,43730,7665,4595
987654596,rashid,70799,41130,29669,4596
987654596,rashid,67158,29650,37508,4596
987654596,rashid,70777,65070,5707,4596
987654596,rashid,67961,42190,25771,4596
987654596,rashid,48700,24030,24670,4596
987654596,rashid,83449,73310,10139,4596
987654596,rashid,84384,76860,7524,4596
987654596,rashid,79038,26310,52728,4596
987654596,rashid,82987,74600,8387,4596
987654596,rashid,109365,104620,4745,4596
987654596,rashid,57698,30220,27478,4596
987654596,rashid,105273,36430,68843,4596
987654596,rashid,75661,53760,21901,4596
987654596,rashid,58974,40750,18224,4596
987654596,rashid,58820,31110,27710,4596
987654596,rashid,43684,19940,23744,4596
987654596,rashid,78576,46650,31926,4596
987654596,rashid,64584,62340,2244,4596
987654596,rashid,75958,53130,22828,4596
987654596,rashid,73505,41150,32355,4596
987654596,rashid,90522,25480,65042,4596
987654596,rashid,48007,30660,17347,4596
987654596,rashid,66025,42640,23385,4596
987654596,rashid,55135,37100,18035,4596
987654597,jitender,58017,21810,36207,4597
987654597,jitender,55553,40910,14643,4597
987654597,jitender,58149,30360,27789,4597
987654597,jitender,48953,37230,11723,4597
987654597,jitender,81040,73760,7280,4597
987654597,jitender,79511,43770,35741,4597
987654597,jitender,76112,54270,21842,4597
987654597,jitender,78565,27560,51005,4597
987654597,jitender,98805,67400,31405,4597
987654597,jitender,53947,27310,26637,4597
987654597,jitender,106021,31280,74741,4597
987654597,jitender,101566,46670,54896,4597
987654597,jitender,82789,68990,13799,4597
987654597,jitender,89928,75750,14178,4597
987654597,jitender,39746,37890,1856,4597
987654597,jitender,65266,49440,15826,4597
987654597,jitender,63363,30980,32383,4597
987654597,jitender,60558,45910,14648,4597
987654597,jitender,57203,51570,5633,4597
987654597,jitender,69886,48480,21406,4597
987654597,jitender,93162,89770,3392,4597
987654597,jitender,98365,67070,31295,4597
987654597,jitender,96979,80030,16949,4597
987654597,jitender,115734,41260,74474,4597
987654598,pawan kumar,50229,20810,29419,4598
987654598,pawan kumar,72878,47820,25058,4598
987654598,pawan kumar,59568,18840,40728,4598
987654598,pawan kumar,66377,53490,12887,4598
987654598,pawan kumar,54761,49770,4991,4598
987654598,pawan kumar,61482,38990,22492,4598
987654598,pawan kumar,47369,21960,25409,4598
987654598,pawan kumar,80567,53700,26867,4598
987654598,pawan kumar,66949,49380,17569,4598
987654598,pawan kumar,74814,51040,23774,4598
987654598,pawan kumar,64837,18580,46257,4598
987654598,pawan kumar,133279,107150,26129,4598
987654598,pawan kumar,53111,37750,15361,4598
987654598,pawan kumar,73923,62880,11043,4598
987654598,pawan kumar,55531,15730,39801,4598
987654598,pawan kumar,57082,33300,23782,4598
987654598,pawan kumar,48414,22930,25484,4598
987654598,pawan kumar,71470,48110,23360,4598
987654598,pawan kumar,47413,42180,5233,4598
987654598,pawan kumar,77179,58730,18449,4598
987654598,pawan kumar,61779,32640,29139,4598
987654598,pawan kumar,78279,60870,17409,4598
987654598,pawan kumar,80985,36810,44175,4598
987654598,pawan kumar,98937,96830,2107,4598
987654599,vivek,46984,27510,19474,4599
987654599,vivek,67147,53120,14027,4599
987654599,vivek,49679,32050,17629,4599
987654599,vivek,55410,39790,15620,4599
987654599,vivek,48700,14070,34630,4599
987654599,vivek,58710,46820,11890,4599
987654599,vivek,46038,35070,10968,4599
987654599,vivek,82503,43710,38793,4599
987654599,vivek,68093,54670,13423,4599
987654599,vivek,84582,46150,38432,4599
987654599,vivek,81678,23370,58308,4599
987654599,vivek,112687,101930,10757,4599
987654599,vivek,58457,56930,1527,4599
987654599,vivek,80424,66370,14054,4599
987654599,vivek,54453,42910,11543,4599
987654599,vivek,51010,38780,12230,4599
987654599,vivek,50801,28700,22101,4599
987654599,vivek,51329,41080,10249,4599
987654599,vivek,49690,16750,32940,4599
987654599,vivek,77883,24320,53563,4599
987654599,vivek,67433,60340,7093,4599
987654599,vivek,76508,35970,40538,4599
987654599,vivek,73406,66430,6976,4599
987654599,vivek,105812,29250,76562,4599
987654600,pintu kumar,48656,46790,1866,4600
987654600,pintu kumar,76629,29310,47319,4600
987654600,pintu kumar,61746,40690,21056,4600
987654600,pintu kumar,58930,58760,170,4600
987654600,pintu kumar,59777,45940,13837,4600
987654600,pintu kumar,62912,58660,4252,4600
987654600,pintu kumar,49063,13940,35123,4600
987654600,pintu kumar,82206,41830,40376,4600
987654600,pintu kumar,72911,47750,25161,4600
987654600,pintu kumar,81854,75540,6314,4600
987654600,pintu kumar,88091,78920,9171,4600
987654600,pintu kumar,110696,81060,29636,4600
987654600,pintu kumar,55124,42570,12554,4600
987654600,pintu kumar,84439,56890,27549,4600
987654600,pintu kumar,53628,15120,38508,4600
987654600,pintu kumar,61394,44900,16494,4600
987654600,pintu kumar,49921,24050,25871,4600
987654600,pintu kumar,55696,16440,39256,4600
987654600,pintu kumar,37986,12010,25976,4600
987654600,pintu kumar,74473,23680,50793,4600
987654600,pintu kumar,71316,32560,38756,4600
987654600,pintu kumar,69985,44200,25785,4600
987654600,pintu kumar,79082,25890,53192,4600
987654600,pintu kumar,100939,53750,47189,4600
987654601,deep,48667,44700,3967,4601
987654601,deep,66476,33330,33146,4601
987654601,deep,53573,39990,13583,4601
987654601,deep,58369,26120,32249,4601
987654601,deep,54233,49960,4273,4601
987654601,deep,57478,31760,25718,4601
987654601,deep,47468,13540,33928,4601
987654601,deep,78983,60970,18013,4601
987654601,deep,76629,26330,50299,4601
987654601,deep,84758,39230,45528,4601
987654601,deep,77784,70280,7504,4601
987654601,deep,110421,62610,47811,4601
987654601,deep,50075,23120,26955,4601
987654601,deep,63858,29000,34858,4601
987654601,deep,61812,52910,8902,4601
987654601,deep,36820,18430,18390,4601
987654601,deep,91435,90220,1215,4601
987654601,deep,54948,26040,28908,4601
987654601,deep,89829,88190,1639,4601
987654601,deep,46929,37190,9739,4601
987654601,deep,148789,142550,6239,4601
987654601,deep,75925,39040,36885,4601
987654601,deep,129748,76100,53648,4601
987654601,deep,119573,52870,66703,4601
987654602,dharmbir,114821,71470,43351,4602
987654602,dharmbir,118825,100570,18255,4602
987654602,dharmbir,161461,147510,13951,4602
987654602,dharmbir,54970,33340,21630,4602
987654602,dharmbir,80072,61860,18212,4602
987654602,dharmbir,71041,63200,7841,4602
987654602,dharmbir,82921,55420,27501,4602
987654602,dharmbir,71063,42980,28083,4602
987654602,dharmbir,67301,25530,41771,4602
987654602,dharmbir,53331,48860,4471,4602
987654602,dharmbir,81051,75500,5551,4602
987654602,dharmbir,100994,66610,34384,4602
987654602,dharmbir,105570,82850,22720,4602
987654602,dharmbir,100873,57570,43303,4602
987654602,dharmbir,122972,118780,4192,4602
987654602,dharmbir,58578,36220,22358,4602
987654602,dharmbir,88201,31400,56801,4602
987654602,dharmbir,68643,28010,40633,4602
987654602,dharmbir,61933,30980,30953,4602
987654602,dharmbir,63825,45700,18125,4602
987654602,dharmbir,73615,32940,40675,4602
987654602,dharmbir,41748,35950,5798,4602
987654602,dharmbir,73978,35540,38438,4602
987654602,dharmbir,79005,43490,35515,4602
987654603,rishi kakdia,86771,24360,62411,4603
987654603,rishi kakdia,86991,40920,46071,4603
987654603,rishi kakdia,113732,39110,74622,4603
987654603,rishi kakdia,49118,17080,32038,4603
987654603,rishi kakdia,66916,29840,37076,4603
987654603,rishi kakdia,53694,15270,38424,4603
987654603,rishi kakdia,60404,30410,29994,4603
987654603,rishi kakdia,56147,50040,6107,4603
987654603,rishi kakdia,60327,24810,35517,4603
987654603,rishi kakdia,52957,46720,6237,4603
987654603,rishi kakdia,81260,75160,6100,4603
987654603,rishi kakdia,72878,60280,12598,4603
987654603,rishi kakdia,81579,75760,5819,4603
987654603,rishi kakdia,83350,82780,570,4603
987654603,rishi kakdia,99883,92710,7173,4603
987654603,rishi kakdia,49426,16870,32556,4603
987654603,rishi kakdia,81480,34570,46910,4603
987654603,rishi kakdia,84054,82740,1314,4603
987654603,rishi kakdia,54409,18590,35819,4603
987654603,rishi kakdia,59282,33660,25622,4603
987654603,rishi kakdia,41891,32060,9831,4603
987654603,rishi kakdia,74594,66860,7734,4603
987654603,rishi kakdia,63286,49930,13356,4603
987654603,rishi kakdia,70821,54680,16141,4603
987654604,kunal,69798,60230,9568,4604
987654604,kunal,89367,51770,37597,4604
987654604,kunal,43750,26330,17420,4604
987654604,kunal,67543,44940,22603,4604
987654604,kunal,57445,37380,20065,4604
987654604,kunal,57038,17080,39958,4604
987654604,kunal,55311,15330,39981,4604
987654604,kunal,61955,48550,13405,4604
987654604,kunal,50229,38450,11779,4604
987654604,kunal,84483,55200,29283,4604
987654604,kunal,72999,58390,14609,4604
987654604,kunal,77168,54170,22998,4604
987654604,kunal,84780,33450,51330,4604
987654604,kunal,106054,63060,42994,4604
987654604,kunal,48876,20620,28256,4604
987654604,kunal,71063,69750,1313,4604
987654604,kunal,70898,42360,28538,4604
987654604,kunal,51406,31550,19856,4604
987654604,kunal,85429,37800,47629,4604
987654604,kunal,43893,27730,16163,4604
987654604,kunal,79335,41940,37395,4604
987654604,kunal,67477,34940,32537,4604
987654604,kunal,73483,29750,43733,4604
987654604,kunal,76629,28180,48449,4604
987654605,arman ansari,91116,53480,37636,4605
987654605,arman ansari,40362,30490,9872,4605
987654605,arman ansari,59931,31760,28171,4605
987654605,arman ansari,52902,23300,29602,4605
987654605,arman ansari,53925,42740,11185,4605
987654605,arman ansari,54211,29230,24981,4605
987654605,arman ansari,56345,16400,39945,4605
987654605,arman ansari,42705,16930,25775,4605
987654605,arman ansari,78433,71790,6643,4605
987654605,arman ansari,69985,65690,4295,4605
987654605,arman ansari,80105,50230,29875,4605
987654605,arman ansari,74154,20280,53874,4605
987654605,arman ansari,98970,27630,71340,4605
987654605,arman ansari,43464,34680,8784,4605
987654605,arman ansari,57489,23000,34489,4605
987654605,arman ansari,49624,41420,8204,4605
987654605,arman ansari,57247,14340,42907,4605
987654605,arman ansari,51362,41100,10262,4605
987654605,arman ansari,61768,30460,31308,4605
987654605,arman ansari,45268,11350,33918,4605
987654605,arman ansari,88443,73840,14603,4605
987654605,arman ansari,70216,59240,10976,4605
987654605,arman ansari,74880,32040,42840,4605
987654605,arman ansari,82063,63030,19033,4605
987654606,avinsh,104811,52450,52361,4606
987654606,avinsh,43717,36110,7607,4606
987654606,avinsh,62538,50420,12118,4606
987654606,avinsh,58457,38050,20407,4606
987654606,avinsh,57038,46350,10688,4606
987654606,avinsh,54486,23380,31106,4606
987654606,avinsh,62923,49340,13583,4606
987654606,avinsh,50328,46280,4048,4606
987654606,avinsh,86353,77360,8993,4606
987654606,avinsh,74990,47880,27110,4606
987654606,avinsh,84956,31890,53066,4606
987654606,avinsh,85550,71450,14100,4606
987654606,avinsh,93338,66830,26508,4606
987654606,avinsh,42166,37960,4206,4606
987654606,avinsh,70788,39620,31168,4606
987654606,avinsh,53529,28420,25109,4606
987654606,avinsh,62736,28660,34076,4606
987654606,avinsh,47237,28410,18827,4606
987654606,avinsh,64430,50180,14250,4606
987654606,avinsh,42716,39280,3436,4606
987654606,avinsh,84989,61430,23559,4606
987654606,avinsh,80754,20980,59774,4606
987654606,avinsh,94328,67920,26408,4606
987654606,avinsh,77883,48320,29563,4606
987654607,karan,99278,64970,34308,4607
987654607,karan,44762,24020,20742,4607
987654607,karan,60646,27530,33116,4607
987654607,karan,52506,22980,29526,4607
987654607,karan,51439,14710,36729,4607
987654607,karan,45103,30680,14423,4607
987654607,karan,60459,58320,2139,4607
987654607,karan,47941,35350,12591,4607
987654607,karan,85638,31470,54168,4607
987654607,karan,70414,66200,4214,4607
987654607,karan,74341,61120,13221,4607
987654607,karan,73296,51730,21566,4607
987654607,karan,105317,58800,46517,4607
987654607,karan,49888,45490,4398,4607
987654607,karan,73648,20830,52818,4607
987654607,karan,62692,49670,13022,4607
987654607,karan,61350,55720,5630,4607
987654607,karan,59821,51910,7911,4607
987654607,karan,62494,53060,9434,4607
987654607,karan,48326,25950,22376,4607
987654607,karan,86837,39010,47827,4607
987654607,karan,69985,62130,7855,4607
987654607,karan,78400,39720,38680,4607
987654607,karan,72757,58240,14517,4607
987654608,sandeep kumar,86562,40730,45832,4608
987654608,sandeep kumar,56565,16790,39775,4608
987654608,sandeep kumar,85363,73590,11773,4608
987654608,sandeep kumar,60085,20850,39235,4608
987654608,sandeep kumar,64298,55940,8358,4608
987654608,sandeep kumar,49954,23530,26424,4608
987654608,sandeep kumar,57687,33270,24417,4608
987654608,sandeep kumar,45499,30200,15299,4608
987654608,sandeep kumar,76343,30540,45803,4608
987654608,sandeep kumar,58622,46340,12282,4608
987654608,sandeep kumar,68797,42700,26097,4608
987654608,sandeep kumar,67070,22190,44880,4608
987654608,sandeep kumar,94955,60000,34955,4608
987654608,sandeep kumar,51527,19720,31807,4608
987654608,sandeep kumar,62043,47690,14353,4608
987654608,sandeep kumar,59953,16020,43933,4608
987654608,sandeep kumar,56906,42770,14136,4608
987654608,sandeep kumar,52198,16630,35568,4608
987654608,sandeep kumar,64826,19550,45276,4608
987654608,sandeep kumar,44663,41380,3283,4608
987654608,sandeep kumar,74594,28140,46454,4608
987654608,sandeep kumar,62494,38170,24324,4608
987654608,sandeep kumar,64463,58790,5673,4608
987654608,sandeep kumar,73461,50710,22751,4608
987654609,sagar,81249,28490,52759,4609
987654609,sagar,52099,25770,26329,4609
987654609,sagar,107121,36350,70771,4609
987654609,sagar,68137,35210,32927,4609
987654609,sagar,68005,51490,16515,4609
987654609,sagar,72207,50750,21457,4609
987654609,sagar,84703,77470,7233,4609
987654609,sagar,40989,38100,2889,4609
987654609,sagar,70623,56070,14553,4609
987654609,sagar,55410,14190,41220,4609
987654609,sagar,59678,37480,22198,4609
987654609,sagar,65310,47490,17820,4609
987654609,sagar,45928,43290,2638,4609
987654609,sagar,78411,42850,35561,4609
987654609,sagar,65882,58740,7142,4609
987654609,sagar,62945,31240,31705,4609
987654609,sagar,71481,56190,15291,4609
987654609,sagar,89367,84800,4567,4609
987654609,sagar,44047,20960,23087,4609
987654609,sagar,77366,47330,30036,4609
987654609,sagar,76849,47140,29709,4609
987654609,sagar,57401,51550,5851,4609
987654609,sagar,56356,25730,30626,4609
987654609,sagar,44223,19680,24543,4609
987654610,nikhil,78334,30810,47524,4610
987654610,nikhil,83988,46400,37588,4610
987654610,nikhil,89246,37430,51816,4610
987654610,nikhil,79808,29970,49838,4610
987654610,nikhil,45609,39950,5659,4610
987654610,nikhil,67620,27530,40090,4610
987654610,nikhil,54299,25680,28619,4610
987654610,nikhil,60393,53850,6543,4610
987654610,nikhil,71063,32060,39003,4610
987654610,nikhil,83295,54830,28465,4610
987654610,nikhil,40670,37090,3580,4610
987654610,nikhil,61064,25400,35664,4610
987654610,nikhil,50405,33540,16865,4610
987654610,nikhil,50548,40010,10538,4610
987654610,nikhil,51043,34640,16403,4610
987654610,nikhil,50647,26500,24147,4610
987654610,nikhil,40329,23210,17119,4610
987654610,nikhil,78620,76410,2210,4610
987654610,nikhil,61163,27280,33883,4610
987654610,nikhil,68335,59360,8975,4610
987654610,nikhil,72361,72100,261,4610
987654610,nikhil,90324,78530,11794,4610
987654610,nikhil,38932,32490,6442,4610
987654610,nikhil,68016,52390,15626,4610
987654611,raman,60613,28420,32193,4611
987654611,raman,57269,50510,6759,4611
987654611,raman,59282,23140,36142,4611
987654611,raman,75694,49300,26394,4611
987654611,raman,115261,92280,22981,4611
987654611,raman,93525,44170,49355,4611
987654611,raman,87398,64570,22828,4611
987654611,raman,100191,87390,12801,4611
987654611,raman,43024,18500,24524,4611
987654611,raman,79401,72870,6531,4611
987654611,raman,68269,37960,30309,4611
987654611,raman,75947,74040,1907,4611
987654611,raman,63957,37190,26767,4611
987654611,raman,100301,80760,19541,4611
987654611,raman,51329,32290,19039,4611
987654611,raman,76453,58290,18163,4611
987654611,raman,62197,48440,13757,4611
987654611,raman,50009,18190,31819,4611
987654611,raman,50218,30220,19998,4611
987654611,raman,55531,15510,40021,4611
987654611,raman,45884,33530,12354,4611
987654611,raman,77740,47680,30060,4611
987654611,raman,74605,26940,47665,4611
987654611,raman,72427,63090,9337,4611
987654612,sujen manjhi,73659,41060,32599,4612
987654612,sujen manjhi,91413,75850,15563,4612
987654612,sujen manjhi,47556,24750,22806,4612
987654612,sujen manjhi,76651,63540,13111,4612
987654612,sujen manjhi,62494,25170,37324,4612
987654612,sujen manjhi,54981,41540,13441,4612
987654612,sujen manjhi,50889,27330,23559,4612
987654612,sujen manjhi,46291,20350,25941,4612
987654612,sujen manjhi,33201,22050,11151,4612
987654612,sujen manjhi,73340,56850,16490,4612
987654612,sujen manjhi,65541,56640,8901,4612
987654612,sujen manjhi,69369,68180,1189,4612
987654612,sujen manjhi,61867,48160,13707,4612
987654612,sujen manjhi,100719,41700,59019,4612
987654612,sujen manjhi,47072,45400,1672,4612
987654612,sujen manjhi,67191,56660,10531,4612
987654612,sujen manjhi,58908,19290,39618,4612
987654612,sujen manjhi,59414,57530,1884,4612
987654612,sujen manjhi,50823,46950,3873,4612
987654612,sujen manjhi,55047,48910,6137,4612
987654612,sujen manjhi,45488,30370,15118,4612
987654612,sujen manjhi,77487,55330,22157,4612
987654612,sujen manjhi,66619,49110,17509,4612
987654612,sujen manjhi,70018,61780,8238,4612
987654613,abhijeet,78059,52300,25759,4613
987654613,abhijeet,85550,63500,22050,4613
987654613,abhijeet,41858,18690,23168,4613
987654613,abhijeet,76057,69830,6227,4613
987654613,abhijeet,63451,39040,24411,4613
987654613,abhijeet,46599,40060,6539,4613
987654613,abhijeet,48931,34320,14611,4613
987654613,abhijeet,52902,43990,8912,4613
987654613,abhijeet,40538,37360,3178,4613
987654613,abhijeet,74407,31480,42927,4613
987654613,abhijeet,66817,39200,27617,4613
987654613,abhijeet,68170,62290,5880,4613
987654613,abhijeet,63759,60270,3489,4613
987654613,abhijeet,70326,28120,42206,4613
987654613,abhijeet,42034,10560,31474,4613
987654613,abhijeet,59920,20690,39230,4613
987654613,abhijeet,52935,40540,12395,4613
987654613,abhijeet,51241,48710,2531,4613
987654613,abhijeet,52088,38940,13148,4613
987654613,abhijeet,57709,39130,18579,4613
987654613,abhijeet,41528,34430,7098,4613
987654613,abhijeet,74847,57850,16997,4613
987654613,abhijeet,76013,59440,16573,4613
987654613,abhijeet,72163,20980,51183,4613
987654614,anshu,73263,36310,36953,4614
987654614,anshu,86353,23980,62373,4614
987654614,anshu,40648,26540,14108,4614
987654614,anshu,67785,55960,11825,4614
987654614,anshu,55993,55780,213,4614
987654614,anshu,56653,21950,34703,4614
987654614,anshu,105603,49990,55613,4614
987654614,anshu,136249,85970,50279,4614
987654614,anshu,118088,33380,84708,4614
987654614,anshu,119804,66690,53114,4614
987654614,anshu,123885,91490,32395,4614
987654614,anshu,72548,43630,28918,4614
987654614,anshu,87948,49610,38338,4614
987654614,anshu,101962,82870,19092,4614
987654614,anshu,79984,23850,56134,4614
987654614,anshu,85429,24130,61299,4614
987654614,anshu,103304,87260,16044,4614
987654614,anshu,58237,54830,3407,4614
987654614,anshu,89367,70900,18467,4614
987654614,anshu,100180,90320,9860,4614
987654614,anshu,90962,69780,21182,4614
987654614,anshu,111609,64840,46769,4614
987654614,anshu,112720,48850,63870,4614
987654614,anshu,58732,16690,42042,4614
987654615,sahil,79291,33350,45941,4615
987654615,sahil,100004,76940,23064,4615
987654615,sahil,84868,78890,5978,4615
987654615,sahil,84032,82280,1752,4615
987654615,sahil,100444,25270,75174,4615
987654615,sahil,59293,56300,2993,4615
987654615,sahil,83108,68560,14548,4615
987654615,sahil,107231,78470,28761,4615
987654615,sahil,98827,26330,72497,4615
987654615,sahil,125667,64370,61297,4615
987654615,sahil,133796,88710,45086,4615
987654615,sahil,72416,28850,43566,4615
987654615,sahil,77135,62150,14985,4615
987654615,sahil,92040,81390,10650,4615
987654615,sahil,89840,87600,2240,4615
987654615,sahil,93712,42000,51712,4615
987654615,sahil,86166,28620,57546,4615
987654615,sahil,57269,23810,33459,4615
987654615,sahil,93635,52130,41505,4615
987654615,sahil,100235,31700,68535,4615
987654615,sahil,106197,27820,78377,4615
987654615,sahil,112533,112190,343,4615
987654615,sahil,91545,43160,48385,4615
987654615,sahil,69402,31650,37752,4615
987654616,aditya som,80182,36890,43292,4616
987654616,aditya som,100510,97110,3400,4616
987654616,aditya som,86166,30330,55836,4616
987654616,aditya som,96363,55280,41083,4616
987654616,aditya som,94768,62870,31898,4616
987654616,aditya som,59942,35800,24142,4616
987654616,aditya som,95824,72720,23104,4616
987654616,aditya som,108034,55420,52614,4616
987654616,aditya som,115954,34100,81854,4616
987654616,aditya som,123885,109380,14505,4616
987654616,aditya som,82404,61680,20724,4616
987654616,aditya som,78532,76880,1652,4616
987654616,aditya som,103997,78690,25307,4616
987654616,aditya som,97969,97280,689,4616
987654616,aditya som,102831,59370,43461,4616
987654616,aditya som,67807,47230,20577,4616
987654616,aditya som,98739,39720,59019,4616
987654616,aditya som,110113,85130,24983,4616
987654616,aditya som,86045,49990,36055,4616
987654616,aditya som,97331,96750,581,4616
987654616,aditya som,113699,81130,32569,4616
987654616,aditya som,64958,23980,40978,4616
987654616,aditya som,86386,21660,64726,4616
987654616,aditya som,106670,70360,36310,4616
987654617,gaurav,96253,43100,53153,4617
987654617,gaurav,92755,63360,29395,4617
987654617,gaurav,73087,52040,21047,4617
987654617,gaurav,90500,37030,53470,4617
987654617,gaurav,118671,106030,12641,4617
987654617,gaurav,94339,59680,34659,4617
987654617,gaurav,109783,59110,50673,4617
987654617,gaurav,118726,72180,46546,4617
987654617,gaurav,81293,61160,20133,4617
987654617,gaurav,120453,88850,31603,4617
987654617,gaurav,98574,30230,68344,4617
987654617,gaurav,81821,22170,59651,4617
987654617,gaurav,120167,47980,72187,4617
987654617,gaurav,69919,26010,43909,4617
987654617,gaurav,75023,74390,633,4617
987654617,gaurav,87893,85080,2813,4617
987654617,gaurav,85462,64340,21122,4617
987654617,gaurav,92326,48910,43416,4617
987654617,gaurav,105284,72380,32904,4617
987654617,gaurav,62054,47720,14334,4617
987654617,gaurav,76189,38120,38069,4617
987654617,gaurav,114040,47300,66740,4617
987654617,gaurav,104635,93900,10735,4617
987654617,gaurav,110432,83870,26562,4617
987654618,raja kumar,118066,49940,68126,4618
987654618,raja kumar,66410,39080,27330,4618
987654618,raja kumar,81623,70790,10833,4618
987654618,raja kumar,97001,37270,59731,4618
987654618,raja kumar,92843,46610,46233,4618
987654618,raja kumar,104976,91700,13276,4618
987654618,raja kumar,63737,51510,12227,4618
987654618,raja kumar,109937,87490,22447,4618
987654618,raja kumar,111686,88240,23446,4618
987654618,raja kumar,108496,65100,43396,4618
987654618,raja kumar,121135,63470,57665,4618
987654618,raja kumar,72768,67460,5308,4618
987654618,raja kumar,87332,55760,31572,4618
987654618,raja kumar,97716,34620,63096,4618
987654618,raja kumar,87211,58480,28731,4618
987654618,raja kumar,86441,76970,9471,4618
987654618,raja kumar,94581,33780,60801,4618
987654618,raja kumar,64716,21130,43586,4618
987654618,raja kumar,83636,29700,53936,4618
987654618,raja kumar,103887,99130,4757,4618
987654618,raja kumar,101907,34860,67047,4618
987654618,raja kumar,103843,75550,28293,4618
987654618,raja kumar,120607,78760,41847,4618
987654618,raja kumar,71415,45190,26225,4618
987654619,sunil,78807,63590,15217,4619
987654619,sunil,91402,82920,8482,4619
987654619,sunil,78169,51930,26239,4619
987654619,sunil,92029,42880,49149,4619
987654619,sunil,94416,85740,8676,4619
987654619,sunil,62626,47070,15556,4619
987654619,sunil,85341,70520,14821,4619
987654619,sunil,101269,61770,39499,4619
987654619,sunil,90137,56870,33267,4619
987654619,sunil,109783,93420,16363,4619
987654619,sunil,108738,56160,52578,4619
987654619,sunil,63924,25780,38144,4619
987654619,sunil,79962,52720,27242,4619
987654619,sunil,95912,59130,36782,4619
987654619,sunil,83130,32330,50800,4619
987654619,sunil,78433,70800,7633,4619
987654619,sunil,85836,51910,33926,4619
987654619,sunil,61559,24350,37209,4619
987654619,sunil,84846,66940,17906,4619
987654619,sunil,100796,87820,12976,4619
987654619,sunil,81128,24670,56458,4619
987654619,sunil,72130,50990,21140,4619
987654619,sunil,113413,73780,39633,4619
987654619,sunil,59249,28640,30609,4619
987654620,ravi kumar,82239,23480,58759,4620
987654620,ravi kumar,94427,38030,56397,4620
987654620,ravi kumar,78103,23860,54243,4620
987654620,ravi kumar,83724,38150,45574,4620
987654620,ravi kumar,80105,51540,28565,4620
987654620,ravi kumar,54959,23200,31759,4620
987654620,ravi kumar,80215,21450,58765,4620
987654620,ravi kumar,94097,80280,13817,4620
987654620,ravi kumar,91105,70420,20685,4620
987654620,ravi kumar,94790,74070,20720,4620
987654620,ravi kumar,91853,46930,44923,4620
987654620,ravi kumar,58985,49140,9845,4620
987654620,ravi kumar,82118,20670,61448,4620
987654620,ravi kumar,104404,91280,13124,4620
987654620,ravi kumar,97144,38770,58374,4620
987654620,ravi kumar,84604,44040,40564,4620
987654620,ravi kumar,113248,98820,14428,4620
987654620,ravi kumar,52407,21410,30997,4620
987654620,ravi kumar,68863,45120,23743,4620
987654620,ravi kumar,76530,35680,40850,4620
987654620,ravi kumar,77102,22970,54132,4620
987654620,ravi kumar,72416,63110,9306,4620
987654620,ravi kumar,90588,30440,60148,4620
987654620,ravi kumar,49459,33490,15969,4620
987654621,shankar kumar,94097,84720,9377,4621
987654621,shankar kumar,105306,62550,42756,4621
987654621,shankar kumar,82877,51210,31667,4621
987654621,shankar kumar,104602,58500,46102,4621
987654621,shankar kumar,115855,93380,22475,4621
987654621,shankar kumar,60712,49890,10822,4621
987654621,shankar kumar,81733,26390,55343,4621
987654621,shankar kumar,101577,83160,18417,4621
987654621,shankar kumar,101159,86430,14729,4621
987654621,shankar kumar,123313,47630,75683,4621
987654621,shankar kumar,50702,25840,24862,4621
987654621,shankar kumar,66938,28870,38068,4621
987654621,shankar kumar,101599,75250,26349,4621
987654621,shankar kumar,61372,42280,19092,4621
987654621,shankar kumar,78719,58290,20429,4621
987654621,shankar kumar,89378,24010,65368,4621
987654621,shankar kumar,79412,72740,6672,4621
987654621,shankar kumar,78224,39540,38684,4621
987654621,shankar kumar,86496,66580,19916,4621
987654621,shankar kumar,53562,48050,5512,4621
987654621,shankar kumar,85693,62210,23483,4621
987654621,shankar kumar,98893,25260,73633,4621
987654621,shankar kumar,96286,83090,13196,4621
987654621,shankar kumar,99564,67380,32184,4621
987654622,vishvash,58897,27800,31097,4622
987654622,vishvash,72570,42550,30020,4622
987654622,vishvash,96275,86330,9945,4622
987654622,vishvash,84252,42920,41332,4622
987654622,vishvash,98926,41170,57756,4622
987654622,vishvash,67598,19590,48008,4622
987654622,vishvash,93547,81550,11997,4622
987654622,vishvash,110311,51050,59261,4622
987654622,vishvash,97936,77460,20476,4622
987654622,vishvash,107627,95950,11677,4622
987654622,vishvash,127581,54330,73251,4622
987654622,vishvash,62824,49840,12984,4622
987654622,vishvash,96682,67130,29552,4622
987654622,vishvash,92337,47330,45007,4622
987654622,vishvash,72768,59730,13038,4622
987654622,vishvash,80776,54200,26576,4622
987654622,vishvash,64012,54030,9982,4622
987654622,vishvash,88971,44010,44961,4622
987654622,vishvash,95274,26010,69264,4622
987654622,vishvash,96055,40780,55275,4622
987654622,vishvash,104910,33580,71330,4622
987654622,vishvash,100224,35660,64564,4622
987654622,vishvash,65827,29360,36467,4622
987654622,vishvash,71481,17950,53531,4622
987654623,sonia,88487,76470,12017,4623
987654623,sonia,77597,27980,49617,4623
987654623,sonia,73384,56250,17134,4623
987654623,sonia,83669,51040,32629,4623
987654623,sonia,57819,57040,779,4623
987654623,sonia,83064,62270,20794,4623
987654623,sonia,105955,33940,72015,4623
987654623,sonia,78279,28890,49389,4623
987654623,sonia,100301,33040,67261,4623
987654623,sonia,110883,47320,63563,4623
987654623,sonia,59623,49220,10403,4623
987654623,sonia,102501,31590,70911,4623
987654623,sonia,113941,33630,80311,4623
987654623,sonia,97287,39110,58177,4623
987654623,sonia,108155,34950,73205,4623
987654623,sonia,61834,50170,11664,4623
987654623,sonia,69270,50750,18520,4623
987654623,sonia,84945,74200,10745,4623
987654623,sonia,85539,30250,55289,4623
987654623,sonia,94295,67400,26895,4623
987654623,sonia,59238,31160,28078,4623
987654623,sonia,120860,53780,67080,4623
987654623,sonia,109695,97330,12365,4623
987654623,sonia,109739,30480,79259,4623
987654624,santosh,124149,122050,2099,4624
987654624,santosh,74407,70690,3717,4624
987654624,santosh,84604,64460,20144,4624
987654624,santosh,93470,39290,54180,4624
987654624,santosh,92315,69030,23285,4624
987654624,santosh,85000,68370,16630,4624
987654624,santosh,113204,31300,81904,4624
987654624,santosh,82954,79080,3874,4624
987654624,santosh,96715,47970,48745,4624
987654624,santosh,115173,57660,57513,4624
987654624,santosh,66377,27610,38767,4624
987654624,santosh,77784,71330,6454,4624
987654624,santosh,89708,82340,7368,4624
987654624,santosh,80072,57630,22442,4624
987654624,santosh,71899,62860,9039,4624
987654624,santosh,89895,77550,12345,4624
987654624,santosh,51769,30150,21619,4624
987654624,santosh,79566,53730,25836,4624
987654624,santosh,96594,63010,33584,4624
987654624,santosh,85000,66120,18880,4624
987654624,santosh,94416,32900,61516,4624
987654624,santosh,110751,47300,63451,4624
987654624,santosh,51428,17800,33628,4624
987654624,santosh,72614,59720,12894,4624
987654625,kayamuddin,84945,48450,36495,4625
987654625,kayamuddin,77355,23960,53395,4625
987654625,kayamuddin,79533,63240,16293,4625
987654625,kayamuddin,89763,32340,57423,4625
987654625,kayamuddin,54882,19670,35212,4625
987654625,kayamuddin,87651,48410,39241,4625
987654625,kayamuddin,98167,55790,42377,4625
987654625,kayamuddin,89829,62800,27029,4625
987654625,kayamuddin,84219,38460,45759,4625
987654625,kayamuddin,107209,82830,24379,4625
987654625,kayamuddin,59172,38010,21162,4625
987654625,kayamuddin,80072,54850,25222,4625
987654625,kayamuddin,88300,85870,2430,4625
987654625,kayamuddin,71547,57390,14157,4625
987654625,kayamuddin,75606,52380,23226,4625
987654625,kayamuddin,84758,39790,44968,4625
987654625,kayamuddin,62934,48460,14474,4625
987654625,kayamuddin,76585,45130,31455,4625
987654625,kayamuddin,97221,63300,33921,4625
987654625,kayamuddin,89268,61890,27378,4625
987654625,kayamuddin,98981,39380,59601,4625
987654625,kayamuddin,102314,95810,6504,4625
987654625,kayamuddin,57632,18400,39232,4625
987654625,kayamuddin,73098,62380,10718,4625
987654626,rohit kumar,92128,87820,4308,4626
987654626,rohit kumar,70623,21450,49173,4626
987654626,rohit kumar,83526,76050,7476,4626
987654626,rohit kumar,81469,32360,49109,4626
987654626,rohit kumar,57269,36540,20729,4626
987654626,rohit kumar,84362,23560,60802,4626
987654626,rohit kumar,104899,74510,30389,4626
987654626,rohit kumar,91952,79610,12342,4626
987654626,rohit kumar,103194,69600,33594,4626
987654626,rohit kumar,107088,64570,42518,4626
987654626,rohit kumar,59161,17430,41731,4626
987654626,rohit kumar,81381,21120,60261,4626
987654626,rohit kumar,79973,46080,33893,4626
987654626,rohit kumar,77157,71370,5787,4626
987654626,rohit kumar,82074,54660,27414,4626
987654626,rohit kumar,75793,58070,17723,4626
987654626,rohit kumar,61383,52830,8553,4626
987654626,rohit kumar,71888,58890,12998,4626
987654626,rohit kumar,94526,23920,70606,4626
987654626,rohit kumar,95571,95450,121,4626
987654626,rohit kumar,84109,72210,11899,4626
987654626,rohit kumar,106252,69790,36462,4626
987654626,rohit kumar,53001,18590,34411,4626
987654626,rohit kumar,58303,33600,24703,4626
987654627,nandkishore karpenter,81062,68800,12262,4627
987654627,nandkishore karpenter,82206,42870,39336,4627
987654627,nandkishore karpenter,66663,36740,29923,4627
987654627,nandkishore karpenter,82074,62330,19744,4627
987654627,nandkishore karpenter,55718,18490,37228,4627
987654627,nandkishore karpenter,86474,72070,14404,4627
987654627,nandkishore karpenter,107990,86490,21500,4627
987654627,nandkishore karpenter,107352,97430,9922,4627
987654627,nandkishore karpenter,133950,61290,72660,4627
987654627,nandkishore karpenter,48194,35240,12954,4627
987654627,nandkishore karpenter,65970,18170,47800,4627
987654627,nandkishore karpenter,90027,48370,41657,4627
987654627,nandkishore karpenter,37579,26710,10869,4627
987654627,nandkishore karpenter,87772,54040,33732,4627
987654627,nandkishore karpenter,57599,52560,5039,4627
987654627,nandkishore karpenter,68236,32560,35676,4627
987654627,nandkishore karpenter,40582,13460,27122,4627
987654627,nandkishore karpenter,129363,112700,16663,4627
987654627,nandkishore karpenter,87640,34790,52850,4627
987654627,nandkishore karpenter,97672,77370,20302,4627
987654627,nandkishore karpenter,128010,45490,82520,4627
987654627,nandkishore karpenter,126481,80650,45831,4627
987654627,nandkishore karpenter,141419,94850,46569,4627
987654627,nandkishore karpenter,138625,65380,73245,4627
987654628,lala bhai,66399,31350,35049,4628
987654628,lala bhai,86089,81960,4129,4628
987654628,lala bhai,92711,54130,38581,4628
987654628,lala bhai,90753,46820,43933,4628
987654628,lala bhai,94900,30460,64440,4628
987654628,lala bhai,94339,62340,31999,4628
987654628,lala bhai,64859,43570,21289,4628
987654628,lala bhai,81359,23370,57989,4628
987654628,lala bhai,117879,103990,13889,4628
987654628,lala bhai,101489,90560,10929,4628
987654628,lala bhai,115965,53040,62925,4628
987654628,lala bhai,116460,83170,33290,4628
987654628,lala bhai,72251,35440,36811,4628
987654628,lala bhai,92117,25730,66387,4628
987654628,lala bhai,98189,52240,45949,4628
987654628,lala bhai,88069,33720,54349,4628
987654628,lala bhai,86892,69620,17272,4628
987654628,lala bhai,95219,60240,34979,4628
987654628,lala bhai,49514,45640,3874,4628
987654628,lala bhai,85220,44340,40880,4628
987654628,lala bhai,98530,95370,3160,4628
987654628,lala bhai,94889,60740,34149,4628
987654628,lala bhai,101676,62940,38736,4628
987654628,lala bhai,115338,104090,11248,4628
987654629,kishan rai,55762,18530,37232,4629
987654629,kishan rai,69578,22990,46588,4629
987654629,kishan rai,81348,78610,2738,4629
987654629,kishan rai,72768,36780,35988,4629
987654629,kishan rai,83779,43200,40579,4629
987654629,kishan rai,93437,91460,1977,4629
987654629,kishan rai,55014,38440,16574,4629
987654629,kishan rai,80182,44400,35782,4629
987654629,kishan rai,105427,32390,73037,4629
987654629,kishan rai,81854,20960,60894,4629
987654629,kishan rai,105537,81180,24357,4629
987654629,kishan rai,121289,36320,84969,4629
987654629,kishan rai,66113,49950,16163,4629
987654629,kishan rai,96011,54810,41201,4629
987654629,kishan rai,83163,67130,16033,4629
987654629,kishan rai,68863,60150,8713,4629
987654629,kishan rai,87893,39890,48003,4629
987654629,kishan rai,55322,46700,8622,4629
987654629,kishan rai,80743,60950,19793,4629
987654629,kishan rai,102215,31740,70475,4629
987654629,kishan rai,87123,32330,54793,4629
987654629,kishan rai,104613,101370,3243,4629
987654629,kishan rai,111532,52400,59132,4629
987654629,kishan rai,68621,18800,49821,4629
987654630,mahender kumar,79588,47250,32338,4630
987654630,mahender kumar,87915,27910,60005,4630
987654630,mahender kumar,70414,68270,2144,4630
987654630,mahender kumar,77916,28800,49116,4630
987654630,mahender kumar,97342,64200,33142,4630
987654630,mahender kumar,58655,51000,7655,4630
987654630,mahender kumar,85924,64560,21364,4630
987654630,mahender kumar,82140,67050,15090,4630
987654630,mahender kumar,93932,93560,372,4630
987654630,mahender kumar,100114,31830,68284,4630
987654630,mahender kumar,120057,93240,26817,4630
987654630,mahender kumar,48436,32850,15586,4630
987654630,mahender kumar,90478,63500,26978,4630
987654630,mahender kumar,86969,25320,61649,4630
987654630,mahender kumar,81359,58630,22729,4630
987654630,mahender kumar,96198,88510,7688,4630
987654630,mahender kumar,55322,41150,14172,4630
987654630,mahender kumar,85198,23060,62138,4630
987654630,mahender kumar,82569,37870,44699,4630
987654630,mahender kumar,86331,77440,8891,4630
987654630,mahender kumar,89059,75240,13819,4630
987654630,mahender kumar,103590,101160,2430,4630
987654630,mahender kumar,57313,52150,5163,4630
987654630,mahender kumar,75925,72220,3705,4630
987654631,deepak,86430,53250,33180,4631
987654631,deepak,58446,32570,25876,4631
987654631,deepak,73109,47320,25789,4631
987654631,deepak,74154,28670,45484,4631
987654631,deepak,57588,21640,35948,4631
987654631,deepak,80798,52180,28618,4631
987654631,deepak,78180,53890,24290,4631
987654631,deepak,98288,96510,1778,4631
987654631,deepak,88212,65080,23132,4631
987654631,deepak,109970,53520,56450,4631
987654631,deepak,50680,25140,25540,4631
987654631,deepak,72834,39900,32934,4631
987654631,deepak,81018,36410,44608,4631
987654631,deepak,80314,62880,17434,4631
987654631,deepak,78708,51320,27388,4631
987654631,deepak,90830,44050,46780,4631
987654631,deepak,57247,27960,29287,4631
987654631,deepak,83240,53590,29650,4631
987654631,deepak,99476,44890,54586,4631
987654631,deepak,91325,42290,49035,4631
987654631,deepak,99773,30780,68993,4631
987654631,deepak,111125,58110,53015,4631
987654631,deepak,57720,27190,30530,4631
987654631,deepak,71866,20430,51436,4631
987654632,mohd afzal,91006,29980,61026,4632
987654632,mohd afzal,81480,44680,36800,4632
987654632,mohd afzal,94922,45480,49442,4632
987654632,mohd afzal,81623,63040,18583,4632
987654632,mohd afzal,55938,48270,7668,4632
987654632,mohd afzal,95241,56600,38641,4632
987654632,mohd afzal,102270,67730,34540,4632
987654632,mohd afzal,101676,43750,57926,4632
987654632,mohd afzal,112291,83050,29241,4632
987654632,mohd afzal,57302,38830,18472,4632
987654632,mohd afzal,55674,23320,32354,4632
987654632,mohd afzal,84329,41660,42669,4632
987654632,mohd afzal,89543,32620,56923,4632
987654632,mohd afzal,75375,46790,28585,4632
987654632,mohd afzal,91358,69980,21378,4632
987654632,mohd afzal,48205,37400,10805,4632
987654632,mohd afzal,89708,68050,21658,4632
987654632,mohd afzal,98442,42360,56082,4632
987654632,mohd afzal,114326,52250,62076,4632
987654632,mohd afzal,114106,53650,60456,4632
987654632,mohd afzal,98068,96930,1138,4632
987654632,mohd afzal,45059,33410,11649,4632
987654632,mohd afzal,67653,52500,15153,4632
987654632,mohd afzal,82811,77710,5101,4632
987654633,satender,65475,23970,41505,4633
987654633,satender,79478,27160,52318,4633
987654633,satender,89862,67100,22762,4633
987654633,satender,53155,18900,34255,4633
987654633,satender,83768,78320,5448,4633
987654633,satender,103128,100400,2728,4633
987654633,satender,88696,24080,64616,4633
987654633,satender,91534,61510,30024,4633
987654633,satender,111510,85680,25830,4633
987654633,satender,62758,17850,44908,4633
987654633,satender,69699,26120,43579,4633
987654633,satender,88080,47470,40610,4633
987654633,satender,80138,51730,28408,4633
987654633,satender,79005,52550,26455,4633
987654633,satender,86221,22540,63681,4633
987654633,satender,54981,43040,11941,4633
987654633,satender,90335,55830,34505,4633
987654633,satender,100609,54230,46379,4633
987654633,satender,90258,42570,47688,4633
987654633,satender,89202,28280,60922,4633
987654633,satender,110003,35740,74263,4633
987654633,satender,47611,43870,3741,4633
987654633,satender,76552,70120,6432,4633
987654633,satender,75628,43890,31738,4633
987654634,shiv prasad singh,74748,64330,10418,4634
987654634,shiv prasad singh,80369,28210,52159,4634
987654634,shiv prasad singh,80226,35740,44486,4634
987654634,shiv prasad singh,58622,28700,29922,4634
987654634,shiv prasad singh,83449,44870,38579,4634
987654634,shiv prasad singh,89026,37530,51496,4634
987654634,shiv prasad singh,78488,27080,51408,4634
987654634,shiv prasad singh,90181,83900,6281,4634
987654634,shiv prasad singh,104426,83760,20666,4634
987654634,shiv prasad singh,53111,45660,7451,4634
987654634,shiv prasad singh,71107,48410,22697,4634
987654634,shiv prasad singh,84406,25490,58916,4634
987654634,shiv prasad singh,81348,69850,11498,4634
987654634,shiv prasad singh,80248,66940,13308,4634
987654634,shiv prasad singh,90170,82070,8100,4634
987654634,shiv prasad singh,47963,37420,10543,4634
987654634,shiv prasad singh,77542,42690,34852,4634
987654634,shiv prasad singh,100543,80710,19833,4634
987654634,shiv prasad singh,84835,78120,6715,4634
987654634,shiv prasad singh,96352,81080,15272,4634
987654634,shiv prasad singh,92854,85610,7244,4634
987654634,shiv prasad singh,63110,52870,10240,4634
987654634,shiv prasad singh,79060,63200,15860,4634
987654634,shiv prasad singh,89730,72890,16840,4634
987654635,mobin,100719,89450,11269,4635
987654635,mobin,96616,93170,3446,4635
987654635,mobin,55960,38840,17120,4635
987654635,mobin,68621,47840,20781,4635
987654635,mobin,87563,37190,50373,4635
987654635,mobin,81733,44610,37123,4635
987654635,mobin,92788,36090,56698,4635
987654635,mobin,58479,30480,27999,4635
987654635,mobin,78807,73790,5017,4635
987654635,mobin,108254,76420,31834,4635
987654635,mobin,90247,35340,54907,4635
987654635,mobin,99707,88160,11547,4635
987654635,mobin,110938,98890,12048,4635
987654635,mobin,57665,25680,31985,4635
987654635,mobin,69347,42130,27217,4635
987654635,mobin,88080,44390,43690,4635
987654635,mobin,82855,71030,11825,4635
987654635,mobin,90291,47790,42501,4635
987654635,mobin,60195,39450,20745,4635
987654635,mobin,93635,65850,27785,4635
987654635,mobin,106505,104660,1845,4635
987654635,mobin,100664,76390,24274,4635
987654635,mobin,107836,43420,64416,4635
987654635,mobin,57071,42330,14741,4635
987654636,khokan sarkar,77080,71990,5090,4636
987654636,khokan sarkar,90863,39550,51313,4636
987654636,khokan sarkar,79984,67690,12294,4636
987654636,khokan sarkar,90423,54720,35703,4636
987654636,khokan sarkar,105801,32330,73471,4636
987654636,khokan sarkar,46863,12910,33953,4636
987654636,khokan sarkar,66729,27520,39209,4636
987654636,khokan sarkar,77432,31870,45562,4636
987654636,khokan sarkar,79467,42980,36487,4636
987654636,khokan sarkar,74770,70460,4310,4636
987654636,khokan sarkar,80336,49220,31116,4636
987654636,khokan sarkar,56323,28980,27343,4636
987654636,khokan sarkar,86001,59950,26051,4636
987654636,khokan sarkar,89290,32140,57150,4636
987654636,khokan sarkar,82745,45050,37695,4636
987654636,khokan sarkar,103645,94500,9145,4636
987654636,khokan sarkar,109695,45880,63815,4636
987654636,khokan sarkar,53716,36760,16956,4636
987654636,khokan sarkar,72185,66850,5335,4636
987654636,khokan sarkar,89378,57910,31468,4636
987654636,khokan sarkar,81645,59820,21825,4636
987654636,khokan sarkar,87167,22880,64287,4636
987654636,khokan sarkar,61900,18180,43720,4636
987654636,khokan sarkar,99729,43830,55899,4636
987654637,vikash,93921,66830,27091,4637
987654637,vikash,90577,60200,30377,4637
987654637,vikash,98013,78250,19763,4637
987654637,vikash,49547,42730,6817,4637
987654637,vikash,72537,69990,2547,4637
987654637,vikash,93899,63560,30339,4637
987654637,vikash,90533,85360,5173,4637
987654637,vikash,109750,49720,60030,4637
987654637,vikash,89477,55770,33707,4637
987654637,vikash,53826,27590,26236,4637
987654637,vikash,61185,17150,44035,4637
987654637,vikash,80435,54610,25825,4637
987654637,vikash,63209,33890,29319,4637
987654637,vikash,74583,34440,40143,4637
987654637,vikash,79797,70560,9237,4637
987654637,vikash,51219,24890,26329,4637
987654637,vikash,81986,32020,49966,4637
987654637,vikash,102545,67110,35435,4637
987654637,vikash,86584,45240,41344,4637
987654637,vikash,92436,74160,18276,4637
987654637,vikash,107979,39610,68369,4637
987654637,vikash,57599,15430,42169,4637
987654637,vikash,69215,44690,24525,4637
987654637,vikash,82316,55410,26906,4637
987654638,krisana braman,76178,24190,51988,4638
987654638,krisana braman,59304,58550,754,4638
987654638,krisana braman,79918,45010,34908,4638
987654638,krisana braman,52286,16840,35446,4638
987654638,krisana braman,73736,69390,4346,4638
987654638,krisana braman,91303,79880,11423,4638
987654638,krisana braman,82437,26550,55887,4638
987654638,krisana braman,91897,45120,46777,4638
987654638,krisana braman,95527,50100,45427,4638
987654638,krisana braman,47116,41660,5456,4638
987654638,krisana braman,65002,55080,9922,4638
987654638,krisana braman,75188,51870,23318,4638
987654638,krisana braman,67191,65530,1661,4638
987654638,krisana braman,46962,37150,9812,4638
987654638,krisana braman,78026,25690,52336,4638
987654638,krisana braman,47831,32110,15721,4638
987654638,krisana braman,74671,66120,8551,4638
987654638,krisana braman,86639,57530,29109,4638
987654638,krisana braman,91996,35980,56016,4638
987654638,krisana braman,94218,82500,11718,4638
987654638,krisana braman,84054,33220,50834,4638
987654638,krisana braman,48403,13490,34913,4638
987654638,krisana braman,62351,53780,8571,4638
987654638,krisana braman,83262,38870,44392,4638
987654639,vipol,93558,68860,24698,4639
987654639,vipol,51351,14510,36841,4639
987654639,vipol,77927,43920,34007,4639
987654639,vipol,44586,42500,2086,4639
987654639,vipol,66938,44490,22448,4639
987654639,vipol,89114,24120,64994,4639
987654639,vipol,88663,26220,62443,4639
987654639,vipol,89015,48850,40165,4639
987654639,vipol,93591,82530,11061,4639
987654639,vipol,63451,61150,2301,4639
987654639,vipol,64452,18230,46222,4639
987654639,vipol,60690,25800,34890,4639
987654639,vipol,66234,48060,18174,4639
987654639,vipol,71294,45990,25304,4639
987654639,vipol,79643,47960,31683,4639
987654639,vipol,49877,15330,34547,4639
987654639,vipol,74275,19210,55065,4639
987654639,vipol,90005,88160,1845,4639
987654639,vipol,85484,38640,46844,4639
987654639,vipol,99795,92720,7075,4639
987654639,vipol,106362,76350,30012,4639
987654639,vipol,40142,23170,16972,4639
987654639,vipol,61669,35900,25769,4639
987654639,vipol,80996,61450,19546,4639
